item	collectible_cols
s	s
object/tangible/dance_prop/generic_must_prop_baton_01_l.iff	trinket_collectible
object/tangible/dance_prop/generic_must_prop_baton_01_r.iff	trinket_collectible
object/tangible/dance_prop/generic_must_prop_baton_02_l.iff	trinket_collectible
object/tangible/dance_prop/generic_must_prop_baton_02_r.iff	trinket_collectible
object/tangible/dance_prop/generic_must_prop_baton_03_l.iff	trinket_collectible
object/tangible/dance_prop/generic_must_prop_baton_03_r.iff	trinket_collectible
object/tangible/dance_prop/generic_must_prop_baton_04_l.iff	trinket_collectible
object/tangible/dance_prop/generic_must_prop_baton_04_r.iff	trinket_collectible
object/tangible/dance_prop/generic_prop_ribbon_spark_r.iff	trinket_collectible
object/tangible/dance_prop/generic_prop_sparkler_l.iff	trinket_collectible
object/tangible/dance_prop/generic_prop_sparkler_r.iff	trinket_collectible
object/tangible/fishing/fish/fish_dathomir_burra.iff	aurebesh_collectible
object/tangible/fishing/fish/fish_endor_buzzfish.iff	aurebesh_collectible
object/tangible/fishing/fish/fish_endor_trout.iff	aurebesh_collectible
object/tangible/fishing/fish/fish_naboo_fatfish.iff	aurebesh_collectible
object/tangible/fishing/fish/fish_naboo_gooberfish.iff	aurebesh_collectible
object/tangible/fishing/fish/fish_naboo_gumfish.iff	aurebesh_collectible
object/tangible/fishing/fish/fish_naboo_mee.iff	aurebesh_collectible
object/tangible/fishing/fish/fish_naboo_see.iff	aurebesh_collectible
object/tangible/fishing/fish/fish_rare_blackfish.iff	aurebesh_collectible
object/tangible/fishing/fish/fish_rare_blowfish.iff	aurebesh_collectible
object/tangible/fishing/fish/fish_rare_bluefish.iff	aurebesh_collectible
object/tangible/fishing/fish/fish_rare_faa.iff	aurebesh_collectible
object/tangible/fishing/fish/fish_rare_laa.iff	aurebesh_collectible
object/tangible/fishing/fish/fish_rare_ray.iff	aurebesh_collectible
object/tangible/fishing/fish/fish_rare_striped.iff	aurebesh_collectible
object/tangible/fishing/fish/fish_yavin_crawlfish.iff	aurebesh_collectible
object/tangible/food/bottle/treasure_bonus_bottle_s01.iff	treasure_collectible
object/tangible/food/bottle/treasure_bonus_bottle_s02.iff	treasure_collectible
object/tangible/food/bottle/treasure_bonus_bottle_s03.iff	treasure_collectible
object/tangible/food/crafted/dessert_pikatta_pie.iff	aurebesh_collectible
object/tangible/food/foraged/edible_jar_berries_generic.iff	aurebesh_collectible
object/tangible/food/foraged/edible_jar_bugs_generic.iff	aurebesh_collectible
object/tangible/food/foraged/edible_jar_fungus_generic.iff	aurebesh_collectible
object/tangible/food/foraged/edible_jar_funk_generic.iff	aurebesh_collectible
object/tangible/food/foraged/edible_jar_livers_generic.iff	aurebesh_collectible
object/tangible/food/foraged/foraged_fruit_s1_generic.iff	aurebesh_collectible
object/tangible/food/foraged/foraged_fruit_s2_generic.iff	aurebesh_collectible
object/tangible/food/foraged/foraged_fruit_s3_generic.iff	aurebesh_collectible
object/tangible/food/foraged/foraged_fruit_s4_generic.iff	aurebesh_collectible
object/tangible/food/foraged/foraged_fruit_s5_generic.iff	aurebesh_collectible
object/tangible/food/foraged/foraged_vegetable_s2_generic.iff	aurebesh_collectible
object/tangible/food/foraged/foraged_vegetable_s3_generic.iff	aurebesh_collectible
object/tangible/food/foraged/foraged_vegetable_s4_generic.iff	aurebesh_collectible
object/tangible/food/foraged/foraged_vegetable_s5_generic.iff	aurebesh_collectible
object/tangible/food/generic/dish_ahrisa.iff	aurebesh_collectible
object/tangible/food/generic/mtp_meatlump_lump_food.iff	aurebesh_collectible
object/tangible/food/mtp_meatlump_xp_wine.iff	aurebesh_collectible
object/tangible/instrument/bandfill.iff	trinket_collectible
object/tangible/instrument/slitherhorn.iff	trinket_collectible
object/tangible/loot/creature_loot/generic/alien_brain.iff	dejarik_collectible
object/tangible/loot/creature_loot/generic/arm_bone_generic.iff	dejarik_collectible
object/tangible/loot/creature_loot/generic/big_tooth_generic.iff	dejarik_collectible
object/tangible/loot/creature_loot/generic/brain_s01.iff	dejarik_collectible
object/tangible/loot/creature_loot/generic/bug_jar.iff	dejarik_collectible
object/tangible/loot/creature_loot/generic/carnivore_tooth.iff	dejarik_collectible
object/tangible/loot/creature_loot/generic/generic_antennae.iff	dejarik_collectible
object/tangible/loot/creature_loot/generic/generic_brain.iff	dejarik_collectible
object/tangible/loot/creature_loot/generic/generic_eye.iff	dejarik_collectible
object/tangible/loot/creature_loot/generic/generic_feather.iff	dejarik_collectible
object/tangible/loot/creature_loot/generic/generic_heart.iff	dejarik_collectible
object/tangible/loot/creature_loot/generic/generic_hide.iff	dejarik_collectible
object/tangible/loot/creature_loot/generic/generic_horn.iff	dejarik_collectible
object/tangible/loot/creature_loot/generic/generic_liver.iff	dejarik_collectible
object/tangible/loot/creature_loot/generic/generic_paw.iff	dejarik_collectible
object/tangible/loot/creature_loot/generic/generic_stomach.iff	dejarik_collectible
object/tangible/loot/creature_loot/generic/guts_jar.iff	dejarik_collectible
object/tangible/loot/creature_loot/generic/heart_s02.iff	dejarik_collectible
object/tangible/loot/creature_loot/generic/heart_s03.iff	dejarik_collectible
object/tangible/loot/creature_loot/generic/humanoid_arm_bone.iff	dejarik_collectible
object/tangible/loot/creature_loot/generic/humanoid_skull.iff	dejarik_collectible
object/tangible/loot/creature_loot/generic/jaw_bone.iff	dejarik_collectible
object/tangible/loot/creature_loot/generic/liver_s02.iff	dejarik_collectible
object/tangible/loot/creature_loot/generic/lizard_scale_generic.iff	dejarik_collectible
object/tangible/loot/creature_loot/generic/lungs_gland.iff	dejarik_collectible
object/tangible/loot/creature_loot/generic/mantis_arm.iff	dejarik_collectible
object/tangible/loot/creature_loot/generic/stomach_s02.iff	dejarik_collectible
object/tangible/loot/creature_loot/generic/thigh_meat_chunk.iff	dejarik_collectible
object/tangible/loot/creature_loot/generic/worm_jar.iff	dejarik_collectible
object/tangible/loot/generic_usable/bacta_ampules_generic.iff	housing_collectible
object/tangible/loot/generic_usable/binoculars_s1_generic.iff	housing_collectible
object/tangible/loot/generic_usable/bottle_liquid_generic.iff	housing_collectible
object/tangible/loot/generic_usable/building_repair_device_generic.iff	housing_collectible
object/tangible/loot/generic_usable/building_repair_device_generic_lt_4.iff	housing_collectible
object/tangible/loot/generic_usable/building_repair_device_generic_st_4.iff	housing_collectible
object/tangible/loot/generic_usable/chem_dispersion_device_generic.iff	housing_collectible
object/tangible/loot/generic_usable/datadisk_generic.iff	housing_collectible
object/tangible/loot/generic_usable/elect_power_unit_generic.iff	housing_collectible
object/tangible/loot/generic_usable/frag_grenade.iff	housing_collectible
object/tangible/loot/generic_usable/frequency_jammer_wire_generic.iff	housing_collectible
object/tangible/loot/generic_usable/generator_device_generic.iff	housing_collectible
object/tangible/loot/generic_usable/generator_device_generic_lt_4.iff	housing_collectible
object/tangible/loot/generic_usable/generic_crystal.iff	housing_collectible
object/tangible/loot/generic_usable/handheld_viewscreen_2_generic.iff	housing_collectible
object/tangible/loot/generic_usable/impulse_detector_01_generic.iff	housing_collectible
object/tangible/loot/generic_usable/jedi_relic_01_generic.iff	housing_collectible
object/tangible/loot/generic_usable/large_dispersal_unit_generic.iff	housing_collectible
object/tangible/loot/generic_usable/large_dispersal_unit_generic_lt_4.iff	housing_collectible
object/tangible/loot/generic_usable/medic_powder_generic.iff	housing_collectible
object/tangible/loot/generic_usable/motivator_device_generic.iff	housing_collectible
object/tangible/loot/generic_usable/power_output_analyzer_generic.iff	housing_collectible
object/tangible/loot/generic_usable/ration_kit_device_generic.iff	housing_collectible
object/tangible/loot/generic_usable/rebreather_generic.iff	housing_collectible
object/tangible/loot/generic_usable/rocket_generic.iff	housing_collectible
object/tangible/loot/generic_usable/scope_weapon_generic.iff	housing_collectible
object/tangible/loot/generic_usable/selonian_psg.iff	housing_collectible
object/tangible/loot/generic_usable/slave_collar_generic.iff	housing_collectible
object/tangible/loot/generic_usable/software_module_generic.iff	housing_collectible
object/tangible/loot/generic_usable/speaker_generic.iff	housing_collectible
object/tangible/loot/generic_usable/sphere_grenade_generic.iff	housing_collectible
object/tangible/loot/generic_usable/spray_bottle_generic.iff	housing_collectible
object/tangible/loot/generic_usable/spray_unit_small_01_generic.iff	housing_collectible
object/tangible/loot/generic_usable/spray_unit_small_generic.iff	housing_collectible
object/tangible/loot/generic_usable/stim_a_generic.iff	housing_collectible
object/tangible/loot/generic_usable/stim_a_generic_lt_4.iff	housing_collectible
object/tangible/loot/generic_usable/stim_a_generic_st_4.iff	housing_collectible
object/tangible/loot/generic_usable/stim_medium_generic.iff	housing_collectible
object/tangible/loot/generic_usable/stim_syringe_generic.iff	housing_collectible
object/tangible/loot/generic_usable/stim_syringe_generic_lt_4.iff	housing_collectible
object/tangible/loot/generic_usable/supplement_liquid.iff	housing_collectible
object/tangible/loot/generic_usable/supplement_solid_pills.iff	housing_collectible
object/tangible/loot/generic_usable/survey_pad_adv_generic.iff	housing_collectible
object/tangible/loot/generic_usable/survey_pad_adv_generic_lt_4.iff	housing_collectible
object/tangible/loot/generic_usable/survey_pad_adv_generic_st_4.iff	housing_collectible
object/tangible/loot/generic_usable/tool_generic.iff	housing_collectible
object/tangible/loot/generic_usable/tube_paste_generic.iff	housing_collectible
object/tangible/loot/generic_usable/tubed_device_generic.iff	housing_collectible
object/tangible/loot/generic_usable/worklight_generic.iff	housing_collectible
object/tangible/loot/npc_loot/aero_magnifier_generic.iff	misc_collectible
object/tangible/loot/npc_loot/answering_machine_generic.iff	misc_collectible
object/tangible/loot/npc_loot/armor_repair_device_generic.iff	misc_collectible
object/tangible/loot/npc_loot/artifact_generic.iff	misc_collectible
object/tangible/loot/npc_loot/bacta_ampules_generic.iff	misc_collectible
object/tangible/loot/npc_loot/basket_generic.iff	misc_collectible
object/tangible/loot/npc_loot/blue_wiring_generic.iff	misc_collectible
object/tangible/loot/npc_loot/bottle_s01_generic.iff	misc_collectible
object/tangible/loot/npc_loot/bottle_s02_generic.iff	misc_collectible
object/tangible/loot/npc_loot/bottle_s03_generic.iff	misc_collectible
object/tangible/loot/npc_loot/bottle_s04_generic.iff	misc_collectible
object/tangible/loot/npc_loot/bowl_generic.iff	misc_collectible
object/tangible/loot/npc_loot/briefcase_generic.iff	misc_collectible
object/tangible/loot/npc_loot/broad_spectrum_med_device_generic.iff	misc_collectible
object/tangible/loot/npc_loot/bug_jar_generic.iff	misc_collectible
object/tangible/loot/npc_loot/cage_generic.iff	misc_collectible
object/tangible/loot/npc_loot/camera_generic.iff	misc_collectible
object/tangible/loot/npc_loot/canister_small_device_generic.iff	misc_collectible
object/tangible/loot/npc_loot/chance_cube_8_generic.iff	misc_collectible
object/tangible/loot/npc_loot/chassis_blueprint_device_generic.iff	misc_collectible
object/tangible/loot/npc_loot/chem_dispersion_device_generic.iff	misc_collectible
object/tangible/loot/npc_loot/circuit_board_generic.iff	misc_collectible
object/tangible/loot/npc_loot/clamp_generic.iff	misc_collectible
object/tangible/loot/npc_loot/clipon_id_badge_generic.iff	misc_collectible
object/tangible/loot/npc_loot/cloth_box_generic.iff	misc_collectible
object/tangible/loot/npc_loot/clothing_repair_device_generic.iff	misc_collectible
object/tangible/loot/npc_loot/comlink_civilian_generic.iff	misc_collectible
object/tangible/loot/npc_loot/copper_battery_generic.iff	misc_collectible
object/tangible/loot/npc_loot/datadisk_generic.iff	misc_collectible
object/tangible/loot/npc_loot/datapad_flashy_generic.iff	misc_collectible
object/tangible/loot/npc_loot/decryptor_generic.iff	misc_collectible
object/tangible/loot/npc_loot/disguise_makeup_kit_generic.iff	misc_collectible
object/tangible/loot/npc_loot/disk_drive_generic.iff	misc_collectible
object/tangible/loot/npc_loot/elect_module_complex_generic.iff	misc_collectible
object/tangible/loot/npc_loot/elect_module_misc_01.iff	misc_collectible
object/tangible/loot/npc_loot/elect_module_simple_generic.iff	misc_collectible
object/tangible/loot/npc_loot/elect_module_wires.iff	misc_collectible
object/tangible/loot/npc_loot/elect_power_unit_generic.iff	misc_collectible
object/tangible/loot/npc_loot/electronic_key_generic.iff	misc_collectible
object/tangible/loot/npc_loot/engineer_analysis_board_generic.iff	misc_collectible
object/tangible/loot/npc_loot/frequency_jammer_wire_generic.iff	misc_collectible
object/tangible/loot/npc_loot/generator_device_generic.iff	misc_collectible
object/tangible/loot/npc_loot/handheld_viewscreen_1_generic.iff	misc_collectible
object/tangible/loot/npc_loot/handheld_viewscreen_2_generic.iff	misc_collectible
object/tangible/loot/npc_loot/healing_chemical_generic.iff	misc_collectible
object/tangible/loot/npc_loot/hyperdrive_part_generic.iff	misc_collectible
object/tangible/loot/npc_loot/id_chip_generic.iff	misc_collectible
object/tangible/loot/npc_loot/impulse_detector_01_generic.iff	misc_collectible
object/tangible/loot/npc_loot/impulse_detector_02_generic.iff	misc_collectible
object/tangible/loot/npc_loot/installation_repair_device_generic.iff	misc_collectible
object/tangible/loot/npc_loot/jewelry_ear_s02.iff	misc_collectible
object/tangible/loot/npc_loot/jewelry_ear_s04.iff	misc_collectible
object/tangible/loot/npc_loot/jewelry_ear_s13.iff	misc_collectible
object/tangible/loot/npc_loot/jewelry_setting_generic.iff	misc_collectible
object/tangible/loot/npc_loot/large_dispersal_unit_generic.iff	misc_collectible
object/tangible/loot/npc_loot/laser_trap_generic.iff	misc_collectible
object/tangible/loot/npc_loot/launcher_tube_generic.iff	misc_collectible
object/tangible/loot/npc_loot/ledger_generic.iff	misc_collectible
object/tangible/loot/npc_loot/magseal_detector_generic.iff	misc_collectible
object/tangible/loot/npc_loot/medical_console_generic.iff	misc_collectible
object/tangible/loot/npc_loot/medical_device_generic.iff	misc_collectible
object/tangible/loot/npc_loot/metal_ball_generic.iff	misc_collectible
object/tangible/loot/npc_loot/metal_barrel_generic.iff	misc_collectible
object/tangible/loot/npc_loot/metal_case_generic.iff	misc_collectible
object/tangible/loot/npc_loot/motivator_device_generic.iff	misc_collectible
object/tangible/loot/npc_loot/notebook_generic.iff	misc_collectible
object/tangible/loot/npc_loot/organichem_stores_generic.iff	misc_collectible
object/tangible/loot/npc_loot/pearl_generic.iff	misc_collectible
object/tangible/loot/npc_loot/power_output_analyzer_generic.iff	misc_collectible
object/tangible/loot/npc_loot/prop_jacket_generic.iff	misc_collectible
object/tangible/loot/npc_loot/radio_generic.iff	misc_collectible
object/tangible/loot/npc_loot/ration_kit_device_generic.iff	misc_collectible
object/tangible/loot/npc_loot/rebreather_generic.iff	misc_collectible
object/tangible/loot/npc_loot/recording_rod_generic.iff	misc_collectible
object/tangible/loot/npc_loot/red_wiring_generic.iff	misc_collectible
object/tangible/loot/npc_loot/rocket_ammo_generic.iff	misc_collectible
object/tangible/loot/npc_loot/rocket_generic.iff	misc_collectible
object/tangible/loot/npc_loot/rusty_toolkit_generic.iff	misc_collectible
object/tangible/loot/npc_loot/scope_weapon_generic.iff	misc_collectible
object/tangible/loot/npc_loot/serum_vial_generic.iff	misc_collectible
object/tangible/loot/npc_loot/shield_module_generic.iff	misc_collectible
object/tangible/loot/npc_loot/shisa_generic.iff	misc_collectible
object/tangible/loot/npc_loot/shoe_soul_generic.iff	misc_collectible
object/tangible/loot/npc_loot/small_motor_generic.iff	misc_collectible
object/tangible/loot/npc_loot/software_module_generic.iff	misc_collectible
object/tangible/loot/npc_loot/software_module_orange_generic.iff	misc_collectible
object/tangible/loot/npc_loot/software_module_red_generic.iff	misc_collectible
object/tangible/loot/npc_loot/speaker_generic.iff	misc_collectible
object/tangible/loot/npc_loot/substance_analyzer_generic.iff	misc_collectible
object/tangible/loot/npc_loot/survey_pad_adv_generic.iff	misc_collectible
object/tangible/loot/npc_loot/survival_equipment_generic.iff	misc_collectible
object/tangible/loot/npc_loot/syringe_generic.iff	misc_collectible
object/tangible/loot/npc_loot/tool_bundle_generic.iff	misc_collectible
object/tangible/loot/npc_loot/tube_paste_generic.iff	misc_collectible
object/tangible/loot/npc_loot/tubed_device_generic.iff	misc_collectible
object/tangible/loot/npc_loot/wiring_generic.iff	misc_collectible
object/tangible/loot/npc_loot/writing_utensils_generic.iff	misc_collectible
object/tangible/medicine/instant_stimpack/bluefish_generic.iff	contraband_collectible
object/tangible/medicine/instant_stimpack/filled_pastry_generic.iff	contraband_collectible
object/tangible/medicine/instant_stimpack/roast_generic.iff	contraband_collectible
object/tangible/medicine/instant_stimpack/stimpack_generic_a.iff	contraband_collectible
object/tangible/medicine/instant_stimpack/stimpack_generic_a.iff	contraband_collectible
object/tangible/medicine/instant_stimpack/stimpack_generic_b.iff	contraband_collectible
object/tangible/medicine/instant_stimpack/stimpack_generic_c.iff	contraband_collectible
object/tangible/medicine/instant_stimpack/stimpack_generic_d.iff	contraband_collectible
object/tangible/medicine/instant_stimpack/stimpack_generic_e.iff	contraband_collectible
object/tangible/medicine/instant_stimpack/stimpack_generic_e_st_3.iff	contraband_collectible
object/tangible/medicine/instant_stimpack/stimpack_syren.iff	contraband_collectible
object/tangible/wearables/armor/bone/armor_bone_s01_bicep_l.iff	generic_collectible
object/tangible/wearables/armor/bone/armor_bone_s01_bicep_r.iff	generic_collectible
object/tangible/wearables/armor/bone/armor_bone_s01_boots.iff	generic_collectible
object/tangible/wearables/armor/bone/armor_bone_s01_bracer_l.iff	generic_collectible
object/tangible/wearables/armor/bone/armor_bone_s01_bracer_r.iff	generic_collectible
object/tangible/wearables/armor/bone/armor_bone_s01_chest_plate.iff	generic_collectible
object/tangible/wearables/armor/bone/armor_bone_s01_gloves.iff	generic_collectible
object/tangible/wearables/armor/bone/armor_bone_s01_helmet.iff	generic_collectible
object/tangible/wearables/armor/bone/armor_bone_s01_leggings.iff	generic_collectible
object/tangible/wearables/armor/chitin/armor_chitin_s01_bicep_l.iff	generic_collectible
object/tangible/wearables/armor/chitin/armor_chitin_s01_bicep_r.iff	generic_collectible
object/tangible/wearables/armor/chitin/armor_chitin_s01_boots.iff	generic_collectible
object/tangible/wearables/armor/chitin/armor_chitin_s01_bracer_l.iff	generic_collectible
object/tangible/wearables/armor/chitin/armor_chitin_s01_bracer_r.iff	generic_collectible
object/tangible/wearables/armor/chitin/armor_chitin_s01_chest_plate.iff	generic_collectible
object/tangible/wearables/armor/chitin/armor_chitin_s01_gloves.iff	generic_collectible
object/tangible/wearables/armor/chitin/armor_chitin_s01_helmet.iff	generic_collectible
object/tangible/wearables/armor/chitin/armor_chitin_s01_leggings.iff	generic_collectible
object/tangible/wearables/armor/composite/armor_composite_bicep_l.iff	generic_collectible
object/tangible/wearables/armor/composite/armor_composite_bicep_r.iff	generic_collectible
object/tangible/wearables/armor/composite/armor_composite_boots.iff	generic_collectible
object/tangible/wearables/armor/composite/armor_composite_bracer_l.iff	generic_collectible
object/tangible/wearables/armor/composite/armor_composite_bracer_r.iff	generic_collectible
object/tangible/wearables/armor/composite/armor_composite_chest_plate.iff	generic_collectible
object/tangible/wearables/armor/composite/armor_composite_gloves.iff	generic_collectible
object/tangible/wearables/armor/composite/armor_composite_helmet.iff	generic_collectible
object/tangible/wearables/armor/composite/armor_composite_leggings.iff	generic_collectible
object/tangible/wearables/armor/ithorian_defender/ith_armor_s01_bicep_l.iff	generic_collectible
object/tangible/wearables/armor/ithorian_defender/ith_armor_s01_bicep_r.iff	generic_collectible
object/tangible/wearables/armor/ithorian_defender/ith_armor_s01_boots.iff	generic_collectible
object/tangible/wearables/armor/ithorian_defender/ith_armor_s01_bracer_l.iff	generic_collectible
object/tangible/wearables/armor/ithorian_defender/ith_armor_s01_bracer_r.iff	generic_collectible
object/tangible/wearables/armor/ithorian_defender/ith_armor_s01_chest_plate.iff	generic_collectible
object/tangible/wearables/armor/ithorian_defender/ith_armor_s01_gloves.iff	generic_collectible
object/tangible/wearables/armor/ithorian_defender/ith_armor_s01_helmet.iff	generic_collectible
object/tangible/wearables/armor/ithorian_defender/ith_armor_s01_leggings.iff	generic_collectible
object/tangible/wearables/armor/ithorian_guardian/ith_armor_s02_bicep_l.iff	generic_collectible
object/tangible/wearables/armor/ithorian_guardian/ith_armor_s02_bicep_r.iff	generic_collectible
object/tangible/wearables/armor/ithorian_guardian/ith_armor_s02_boots.iff	generic_collectible
object/tangible/wearables/armor/ithorian_guardian/ith_armor_s02_bracer_l.iff	generic_collectible
object/tangible/wearables/armor/ithorian_guardian/ith_armor_s02_bracer_r.iff	generic_collectible
object/tangible/wearables/armor/ithorian_guardian/ith_armor_s02_chest_plate.iff	generic_collectible
object/tangible/wearables/armor/ithorian_guardian/ith_armor_s02_gloves.iff	generic_collectible
object/tangible/wearables/armor/ithorian_guardian/ith_armor_s02_helmet.iff	generic_collectible
object/tangible/wearables/armor/ithorian_guardian/ith_armor_s02_leggings.iff	generic_collectible
object/tangible/wearables/armor/ithorian_sentinel/ith_armor_s03_bicep_l.iff	generic_collectible
object/tangible/wearables/armor/ithorian_sentinel/ith_armor_s03_bicep_r.iff	generic_collectible
object/tangible/wearables/armor/ithorian_sentinel/ith_armor_s03_boots.iff	generic_collectible
object/tangible/wearables/armor/ithorian_sentinel/ith_armor_s03_bracer_l.iff	generic_collectible
object/tangible/wearables/armor/ithorian_sentinel/ith_armor_s03_bracer_r.iff	generic_collectible
object/tangible/wearables/armor/ithorian_sentinel/ith_armor_s03_chest_plate.iff	generic_collectible
object/tangible/wearables/armor/ithorian_sentinel/ith_armor_s03_gloves.iff	generic_collectible
object/tangible/wearables/armor/ithorian_sentinel/ith_armor_s03_helmet.iff	generic_collectible
object/tangible/wearables/armor/ithorian_sentinel/ith_armor_s03_leggings.iff	generic_collectible
object/tangible/wearables/armor/kashyyykian_black_mtn/armor_kashyyykian_black_mtn_bicep_l.iff	generic_collectible
object/tangible/wearables/armor/kashyyykian_black_mtn/armor_kashyyykian_black_mtn_bicep_r.iff	generic_collectible
object/tangible/wearables/armor/kashyyykian_black_mtn/armor_kashyyykian_black_mtn_bracer_l.iff	generic_collectible
object/tangible/wearables/armor/kashyyykian_black_mtn/armor_kashyyykian_black_mtn_bracer_r.iff	generic_collectible
object/tangible/wearables/armor/kashyyykian_black_mtn/armor_kashyyykian_black_mtn_chestplate.iff	generic_collectible
object/tangible/wearables/armor/kashyyykian_black_mtn/armor_kashyyykian_black_mtn_leggings.iff	generic_collectible
object/tangible/wearables/armor/kashyyykian_ceremonial/armor_kashyyykian_ceremonial_bicep_l.iff	generic_collectible
object/tangible/wearables/armor/kashyyykian_ceremonial/armor_kashyyykian_ceremonial_bicep_r.iff	generic_collectible
object/tangible/wearables/armor/kashyyykian_ceremonial/armor_kashyyykian_ceremonial_bracer_l.iff	generic_collectible
object/tangible/wearables/armor/kashyyykian_ceremonial/armor_kashyyykian_ceremonial_bracer_r.iff	generic_collectible
object/tangible/wearables/armor/kashyyykian_ceremonial/armor_kashyyykian_ceremonial_chestplate.iff	generic_collectible
object/tangible/wearables/armor/kashyyykian_ceremonial/armor_kashyyykian_ceremonial_leggings.iff	generic_collectible
object/tangible/wearables/armor/kashyyykian_hunting/armor_kashyyykian_hunting_bicep_l.iff	generic_collectible
object/tangible/wearables/armor/kashyyykian_hunting/armor_kashyyykian_hunting_bicep_r.iff	generic_collectible
object/tangible/wearables/armor/kashyyykian_hunting/armor_kashyyykian_hunting_bracer_l.iff	generic_collectible
object/tangible/wearables/armor/kashyyykian_hunting/armor_kashyyykian_hunting_bracer_r.iff	generic_collectible
object/tangible/wearables/armor/kashyyykian_hunting/armor_kashyyykian_hunting_chestplate.iff	generic_collectible
object/tangible/wearables/armor/kashyyykian_hunting/armor_kashyyykian_hunting_leggings.iff	generic_collectible
object/tangible/wearables/armor/mandalorian_imperial/armor_mandalorian_imperial_belt.iff	generic_collectible
object/tangible/wearables/armor/mandalorian_imperial/armor_mandalorian_imperial_bicep_l.iff	generic_collectible
object/tangible/wearables/armor/mandalorian_imperial/armor_mandalorian_imperial_bicep_r.iff	generic_collectible
object/tangible/wearables/armor/mandalorian_imperial/armor_mandalorian_imperial_boots.iff	generic_collectible
object/tangible/wearables/armor/mandalorian_imperial/armor_mandalorian_imperial_bracer_l.iff	generic_collectible
object/tangible/wearables/armor/mandalorian_imperial/armor_mandalorian_imperial_bracer_r.iff	generic_collectible
object/tangible/wearables/armor/mandalorian_imperial/armor_mandalorian_imperial_chest_plate.iff	generic_collectible
object/tangible/wearables/armor/mandalorian_imperial/armor_mandalorian_imperial_gloves.iff	generic_collectible
object/tangible/wearables/armor/mandalorian_imperial/armor_mandalorian_imperial_helmet.iff	generic_collectible
object/tangible/wearables/armor/mandalorian_imperial/armor_mandalorian_imperial_leggings.iff	generic_collectible
object/tangible/wearables/armor/mandalorian_rebel/armor_mandalorian_rebel_belt.iff	generic_collectible
object/tangible/wearables/armor/mandalorian_rebel/armor_mandalorian_rebel_bicep_l.iff	generic_collectible
object/tangible/wearables/armor/mandalorian_rebel/armor_mandalorian_rebel_bicep_r.iff	generic_collectible
object/tangible/wearables/armor/mandalorian_rebel/armor_mandalorian_rebel_boots.iff	generic_collectible
object/tangible/wearables/armor/mandalorian_rebel/armor_mandalorian_rebel_bracer_l.iff	generic_collectible
object/tangible/wearables/armor/mandalorian_rebel/armor_mandalorian_rebel_bracer_r.iff	generic_collectible
object/tangible/wearables/armor/mandalorian_rebel/armor_mandalorian_rebel_chest_plate.iff	generic_collectible
object/tangible/wearables/armor/mandalorian_rebel/armor_mandalorian_rebel_gloves.iff	generic_collectible
object/tangible/wearables/armor/mandalorian_rebel/armor_mandalorian_rebel_helmet.iff	generic_collectible
object/tangible/wearables/armor/mandalorian_rebel/armor_mandalorian_rebel_leggings.iff	generic_collectible
object/tangible/wearables/armor/padded/armor_padded_s01_bicep_l.iff	generic_collectible
object/tangible/wearables/armor/padded/armor_padded_s01_bicep_r.iff	generic_collectible
object/tangible/wearables/armor/padded/armor_padded_s01_boots.iff	generic_collectible
object/tangible/wearables/armor/padded/armor_padded_s01_bracer_l.iff	generic_collectible
object/tangible/wearables/armor/padded/armor_padded_s01_bracer_r.iff	generic_collectible
object/tangible/wearables/armor/padded/armor_padded_s01_chest_plate.iff	generic_collectible
object/tangible/wearables/armor/padded/armor_padded_s01_gloves.iff	generic_collectible
object/tangible/wearables/armor/padded/armor_padded_s01_helmet.iff	generic_collectible
object/tangible/wearables/armor/padded/armor_padded_s01_leggings.iff	generic_collectible
object/tangible/wearables/armor/tantel/armor_tantel_skreej_bicep_l.iff	generic_collectible
object/tangible/wearables/armor/tantel/armor_tantel_skreej_bicep_r.iff	generic_collectible
object/tangible/wearables/armor/tantel/armor_tantel_skreej_boots.iff	generic_collectible
object/tangible/wearables/armor/tantel/armor_tantel_skreej_bracer_l.iff	generic_collectible
object/tangible/wearables/armor/tantel/armor_tantel_skreej_bracer_r.iff	generic_collectible
object/tangible/wearables/armor/tantel/armor_tantel_skreej_chest_plate.iff	generic_collectible
object/tangible/wearables/armor/tantel/armor_tantel_skreej_gloves.iff	generic_collectible
object/tangible/wearables/armor/tantel/armor_tantel_skreej_helmet.iff	generic_collectible
object/tangible/wearables/armor/tantel/armor_tantel_skreej_leggings.iff	generic_collectible
object/tangible/wearables/armor/ubese/armor_ubese_boots.iff	generic_collectible
object/tangible/wearables/armor/ubese/armor_ubese_bracer_l.iff	generic_collectible
object/tangible/wearables/armor/ubese/armor_ubese_bracer_r.iff	generic_collectible
object/tangible/wearables/armor/ubese/armor_ubese_gloves.iff	generic_collectible
object/tangible/wearables/armor/ubese/armor_ubese_helmet.iff	generic_collectible
object/tangible/wearables/armor/ubese/armor_ubese_jacket.iff	generic_collectible
object/tangible/wearables/armor/ubese/armor_ubese_pants.iff	generic_collectible
object/tangible/wearables/armor/ubese/armor_ubese_shirt.iff	generic_collectible
object/tangible/wearables/backpack/backpack_s01.iff	generic_collectible
object/tangible/wearables/backpack/backpack_s03.iff	generic_collectible
object/tangible/wearables/backpack/backpack_s04.iff	generic_collectible
object/tangible/wearables/backpack/backpack_s05.iff	generic_collectible
object/tangible/wearables/backpack/backpack_s06.iff	generic_collectible
object/tangible/wearables/bandolier/bandolier_s02.iff	generic_collectible
object/tangible/wearables/bandolier/bandolier_s03.iff	generic_collectible
object/tangible/wearables/bandolier/bandolier_s04.iff	generic_collectible
object/tangible/wearables/bandolier/bandolier_s05.iff	generic_collectible
object/tangible/wearables/bandolier/bandolier_s06.iff	generic_collectible
object/tangible/wearables/bandolier/bandolier_s07.iff	generic_collectible
object/tangible/wearables/bandolier/bandolier_s08.iff	generic_collectible
object/tangible/wearables/belt/belt_faux_mabari_generic.iff	generic_collectible
object/tangible/wearables/belt/belt_s01.iff	generic_collectible
object/tangible/wearables/belt/belt_s02.iff	generic_collectible
object/tangible/wearables/belt/belt_s03.iff	generic_collectible
object/tangible/wearables/belt/belt_s04.iff	generic_collectible
object/tangible/wearables/belt/belt_s05.iff	generic_collectible
object/tangible/wearables/belt/belt_s07.iff	generic_collectible
object/tangible/wearables/belt/belt_s09.iff	generic_collectible
object/tangible/wearables/belt/belt_s11.iff	generic_collectible
object/tangible/wearables/belt/belt_s12.iff	generic_collectible
object/tangible/wearables/belt/belt_s13.iff	generic_collectible
object/tangible/wearables/belt/belt_s14.iff	generic_collectible
object/tangible/wearables/belt/belt_s15.iff	generic_collectible
object/tangible/wearables/belt/belt_s16.iff	generic_collectible
object/tangible/wearables/belt/belt_s17.iff	generic_collectible
object/tangible/wearables/belt/belt_s18.iff	generic_collectible
object/tangible/wearables/belt/belt_s19.iff	generic_collectible
object/tangible/wearables/belt/belt_s20.iff	generic_collectible
object/tangible/wearables/bikini/bikini_s03.iff	generic_collectible
object/tangible/wearables/bodysuit/bodysuit_s08_generic.iff	generic_collectible
object/tangible/wearables/bodysuit/bodysuit_s13.iff	generic_collectible
object/tangible/wearables/boots/boots_s03.iff	generic_collectible
object/tangible/wearables/boots/boots_s04.iff	generic_collectible
object/tangible/wearables/boots/boots_s05.iff	generic_collectible
object/tangible/wearables/boots/boots_s12.iff	generic_collectible
object/tangible/wearables/boots/boots_s14.iff	generic_collectible
object/tangible/wearables/boots/boots_s15.iff	generic_collectible
object/tangible/wearables/boots/boots_s19.iff	generic_collectible
object/tangible/wearables/boots/boots_s21.iff	generic_collectible
object/tangible/wearables/boots/boots_s22.iff	generic_collectible
object/tangible/wearables/boots/boots_s34.iff	generic_collectible
object/tangible/wearables/bracelet/bracelet_s02_l.iff	generic_collectible
object/tangible/wearables/bracelet/bracelet_s02_r.iff	generic_collectible
object/tangible/wearables/bracelet/bracelet_s03_l.iff	generic_collectible
object/tangible/wearables/bracelet/bracelet_s03_r.iff	generic_collectible
object/tangible/wearables/bracelet/bracelet_s04_l.iff	generic_collectible
object/tangible/wearables/bracelet/bracelet_s04_r.iff	generic_collectible
object/tangible/wearables/bracelet/bracelet_s05_l.iff	generic_collectible
object/tangible/wearables/bracelet/bracelet_s05_r.iff	generic_collectible
object/tangible/wearables/bracelet/bracelet_s06_l.iff	generic_collectible
object/tangible/wearables/bracelet/bracelet_s06_r.iff	generic_collectible
object/tangible/wearables/gloves/gloves_s02.iff	generic_collectible
object/tangible/wearables/gloves/gloves_s03.iff	generic_collectible
object/tangible/wearables/gloves/gloves_s06.iff	generic_collectible
object/tangible/wearables/gloves/gloves_s07.iff	generic_collectible
object/tangible/wearables/gloves/gloves_s10.iff	generic_collectible
object/tangible/wearables/gloves/gloves_s11.iff	generic_collectible
object/tangible/wearables/gloves/gloves_s12.iff	generic_collectible
object/tangible/wearables/gloves/gloves_s13.iff	generic_collectible
object/tangible/wearables/gloves/gloves_s14.iff	generic_collectible
object/tangible/wearables/hat/hat_s02.iff	generic_collectible
object/tangible/wearables/hat/hat_s02_generic.iff	generic_collectible
object/tangible/wearables/hat/hat_s04.iff	generic_collectible
object/tangible/wearables/hat/hat_s10.iff	generic_collectible
object/tangible/wearables/hat/hat_s12.iff	generic_collectible
object/tangible/wearables/hat/hat_s13.iff	generic_collectible
object/tangible/wearables/hat/hat_s14.iff	generic_collectible
object/tangible/wearables/hat/hat_twilek_s03.iff	generic_collectible
object/tangible/wearables/helmet/helmet_s06.iff	generic_collectible
object/tangible/wearables/ithorian/ith_bodysuit_s01.iff	generic_collectible
object/tangible/wearables/ithorian/ith_bodysuit_s02.iff	generic_collectible
object/tangible/wearables/ithorian/ith_bodysuit_s06.iff	generic_collectible
object/tangible/wearables/ithorian/ith_gloves_s02.iff	generic_collectible
object/tangible/wearables/ithorian/ith_hat_s01.iff	generic_collectible
object/tangible/wearables/ithorian/ith_hat_s02.iff	generic_collectible
object/tangible/wearables/ithorian/ith_hat_s04.iff	generic_collectible
object/tangible/wearables/ithorian/ith_pants_s19.iff	generic_collectible
object/tangible/wearables/ithorian/ith_shirt_s09.iff	generic_collectible
object/tangible/wearables/ithorian/ith_vest_s02.iff	generic_collectible
object/tangible/wearables/jacket/jacket_s02.iff	generic_collectible
object/tangible/wearables/jacket/jacket_s03.iff	generic_collectible
object/tangible/wearables/jacket/jacket_s05.iff	generic_collectible
object/tangible/wearables/jacket/jacket_s06.iff	generic_collectible
object/tangible/wearables/jacket/jacket_s07.iff	generic_collectible
object/tangible/wearables/jacket/jacket_s08.iff	generic_collectible
object/tangible/wearables/jacket/jacket_s10.iff	generic_collectible
object/tangible/wearables/jacket/jacket_s11.iff	generic_collectible
object/tangible/wearables/jacket/jacket_s12.iff	generic_collectible
object/tangible/wearables/jacket/jacket_s13.iff	generic_collectible
object/tangible/wearables/jacket/jacket_s14.iff	generic_collectible
object/tangible/wearables/jacket/jacket_s15.iff	generic_collectible
object/tangible/wearables/jacket/jacket_s16.iff	generic_collectible
object/tangible/wearables/jacket/jacket_s17.iff	generic_collectible
object/tangible/wearables/jacket/jacket_s18.iff	generic_collectible
object/tangible/wearables/jacket/jacket_s19.iff	generic_collectible
object/tangible/wearables/jacket/jacket_s21.iff	generic_collectible
object/tangible/wearables/jacket/jacket_s22.iff	generic_collectible
object/tangible/wearables/jacket/jacket_s24.iff	generic_collectible
object/tangible/wearables/jacket/jacket_s25.iff	generic_collectible
object/tangible/wearables/jacket/jacket_s35.iff	generic_collectible
object/tangible/wearables/jacket/jacket_s36.iff	generic_collectible
object/tangible/wearables/necklace/necklace_ace_pilot_empire.iff	generic_collectible
object/tangible/wearables/necklace/necklace_ace_pilot_neutral.iff	generic_collectible
object/tangible/wearables/necklace/necklace_ace_pilot_rebel.iff	generic_collectible
object/tangible/wearables/necklace/necklace_s01.iff	generic_collectible
object/tangible/wearables/necklace/necklace_s02.iff	generic_collectible
object/tangible/wearables/necklace/necklace_s03.iff	generic_collectible
object/tangible/wearables/necklace/necklace_s04.iff	generic_collectible
object/tangible/wearables/necklace/necklace_s05.iff	generic_collectible
object/tangible/wearables/necklace/necklace_s06.iff	generic_collectible
object/tangible/wearables/necklace/necklace_s07.iff	generic_collectible
object/tangible/wearables/necklace/necklace_s08.iff	generic_collectible
object/tangible/wearables/necklace/necklace_s09.iff	generic_collectible
object/tangible/wearables/necklace/necklace_s10.iff	generic_collectible
object/tangible/wearables/necklace/necklace_s11.iff	generic_collectible
object/tangible/wearables/necklace/necklace_s12.iff	generic_collectible
object/tangible/wearables/pants/pants_s01.iff	generic_collectible
object/tangible/wearables/pants/pants_s04.iff	generic_collectible
object/tangible/wearables/pants/pants_s05.iff	generic_collectible
object/tangible/wearables/pants/pants_s06.iff	generic_collectible
object/tangible/wearables/pants/pants_s07.iff	generic_collectible
object/tangible/wearables/pants/pants_s08.iff	generic_collectible
object/tangible/wearables/pants/pants_s09.iff	generic_collectible
object/tangible/wearables/pants/pants_s10.iff	generic_collectible
object/tangible/wearables/pants/pants_s11.iff	generic_collectible
object/tangible/wearables/pants/pants_s12.iff	generic_collectible
object/tangible/wearables/pants/pants_s13.iff	generic_collectible
object/tangible/wearables/pants/pants_s14.iff	generic_collectible
object/tangible/wearables/pants/pants_s15.iff	generic_collectible
object/tangible/wearables/pants/pants_s18.iff	generic_collectible
object/tangible/wearables/pants/pants_s21.iff	generic_collectible
object/tangible/wearables/pants/pants_s22.iff	generic_collectible
object/tangible/wearables/pants/pants_s24.iff	generic_collectible
object/tangible/wearables/pants/pants_s25.iff	generic_collectible
object/tangible/wearables/pants/pants_s26.iff	generic_collectible
object/tangible/wearables/pants/pants_s27.iff	generic_collectible
object/tangible/wearables/pants/pants_s28.iff	generic_collectible
object/tangible/wearables/pants/pants_s29.iff	generic_collectible
object/tangible/wearables/pants/pants_s30.iff	generic_collectible
object/tangible/wearables/pants/pants_s31.iff	generic_collectible
object/tangible/wearables/pants/pants_s33.iff	generic_collectible
object/tangible/wearables/ring/ring_s01.iff	shard_collectible
object/tangible/wearables/ring/ring_s02.iff	shard_collectible
object/tangible/wearables/ring/ring_s03.iff	shard_collectible
object/tangible/wearables/ring/ring_s04.iff	shard_collectible
object/tangible/wearables/robe/robe_jedi_dark_s01.iff	shard_collectible
object/tangible/wearables/robe/robe_jedi_dark_s02.iff	shard_collectible
object/tangible/wearables/robe/robe_jedi_light_s01.iff	shard_collectible
object/tangible/wearables/robe/robe_jedi_light_s02.iff	shard_collectible
object/tangible/wearables/robe/robe_s05.iff	generic_collectible
object/tangible/wearables/robe/robe_s05_h1.iff	generic_collectible
object/tangible/wearables/robe/robe_s27.iff	generic_collectible
object/tangible/wearables/shirt/shirt_s03.iff	generic_collectible
object/tangible/wearables/shirt/shirt_s04.iff	generic_collectible
object/tangible/wearables/shirt/shirt_s05.iff	generic_collectible
object/tangible/wearables/shirt/shirt_s07.iff	generic_collectible
object/tangible/wearables/shirt/shirt_s08.iff	generic_collectible
object/tangible/wearables/shirt/shirt_s09.iff	generic_collectible
object/tangible/wearables/shirt/shirt_s10.iff	generic_collectible
object/tangible/wearables/shirt/shirt_s11.iff	generic_collectible
object/tangible/wearables/shirt/shirt_s13.iff	generic_collectible
object/tangible/wearables/shirt/shirt_s14.iff	generic_collectible
object/tangible/wearables/shirt/shirt_s15.iff	generic_collectible
object/tangible/wearables/shirt/shirt_s16.iff	generic_collectible
object/tangible/wearables/shirt/shirt_s26.iff	generic_collectible
object/tangible/wearables/shirt/shirt_s27.iff	generic_collectible
object/tangible/wearables/shirt/shirt_s30.iff	generic_collectible
object/tangible/wearables/shirt/shirt_s32.iff	generic_collectible
object/tangible/wearables/shirt/shirt_s34.iff	generic_collectible
object/tangible/wearables/shirt/shirt_s38.iff	generic_collectible
object/tangible/wearables/shirt/shirt_s42.iff	generic_collectible
object/tangible/wearables/shoes/shoes_s01.iff	generic_collectible
object/tangible/wearables/shoes/shoes_s02.iff	generic_collectible
object/tangible/wearables/shoes/shoes_s03.iff	generic_collectible
object/tangible/wearables/shoes/shoes_s07.iff	generic_collectible
object/tangible/wearables/shoes/shoes_s09.iff	generic_collectible
object/tangible/wearables/skirt/skirt_s10.iff	generic_collectible
object/tangible/wearables/vest/vest_s01.iff	generic_collectible
object/tangible/wearables/vest/vest_s02.iff	generic_collectible
object/tangible/wearables/vest/vest_s03.iff	generic_collectible
object/tangible/wearables/vest/vest_s04.iff	generic_collectible
object/tangible/wearables/vest/vest_s05.iff	generic_collectible
object/tangible/wearables/vest/vest_s06.iff	generic_collectible
object/tangible/wearables/vest/vest_s09.iff	generic_collectible
object/tangible/wearables/vest/vest_s10.iff	generic_collectible
object/tangible/wearables/vest/vest_s11.iff	generic_collectible
object/tangible/wearables/vest/vest_s15.iff	generic_collectible
object/tangible/wearables/wookiee/wke_gloves_s04.iff	generic_collectible
object/tangible/wearables/wookiee/wke_hood_s03.iff	generic_collectible
object/tangible/wearables/wookiee/wke_shirt_s01.iff	generic_collectible
object/tangible/wearables/wookiee/wke_shirt_s02.iff	generic_collectible
object/tangible/wearables/wookiee/wke_shoulder_pad_s01.iff	generic_collectible
object/tangible/wearables/wookiee/wke_shoulder_pad_s02.iff	generic_collectible
object/tangible/wearables/wookiee/wke_skirt_s03.iff	generic_collectible
object/weapon/melee/2h_sword/2h_sword_battleaxe.iff	generic_collectible
object/weapon/melee/2h_sword/2h_sword_battleaxe_npe.iff	generic_collectible
object/weapon/melee/2h_sword/2h_sword_cleaver_npe.iff	generic_collectible
object/weapon/melee/2h_sword/2h_sword_katana_generic.iff	generic_collectible
object/weapon/melee/2h_sword/2h_sword_maul.iff	generic_collectible
object/weapon/melee/2h_sword/2h_sword_sith_generic.iff	generic_collectible
object/weapon/melee/2h_sword/som_2h_sword_massassi.iff	generic_collectible
object/weapon/melee/2h_sword/som_2h_sword_obsidian_generic.iff	generic_collectible
object/weapon/melee/2h_sword/som_2h_sword_tulrus_generic.iff	generic_collectible
object/weapon/melee/axe/axe_heavy_duty_npe.iff	generic_collectible
object/weapon/melee/baton/baton_gaderiffi_npe.iff	generic_collectible
object/weapon/melee/knife/knife_dagger_static.iff	generic_collectible
object/weapon/melee/polearm/lance_controllerfp_npe.iff	generic_collectible
object/weapon/melee/polearm/lance_kaminoan_generic.iff	generic_collectible
object/weapon/melee/polearm/lance_kashyyk_generic.iff	generic_collectible
object/weapon/melee/polearm/lance_staff_wood_s2.iff	generic_collectible
object/weapon/melee/polearm/lance_staff_wood_s2_npe.iff	generic_collectible
object/weapon/melee/polearm/polearm_vibro_axe_npe.iff	generic_collectible
object/weapon/melee/polearm/som_lance_obsidian_generic.iff	generic_collectible
object/weapon/melee/polearm/som_lance_xandank_generic.iff	generic_collectible
object/weapon/melee/special/blacksun_razor_generic.iff	generic_collectible
object/weapon/melee/special/blasterfist_generic.iff	generic_collectible
object/weapon/melee/special/massassiknuckler_generic.iff	generic_collectible
object/weapon/melee/special/vibroknuckler_npe.iff	generic_collectible
object/weapon/melee/special/vibroknuckler_static.iff	generic_collectible
object/weapon/melee/sword/crafted_saber/sword_lightsaber_mandalorian.iff	generic_collectible
object/weapon/melee/sword/som_sword_mustafar_bandit_generic.iff	generic_collectible
object/weapon/melee/sword/som_sword_obsidian_generic.iff	generic_collectible
object/weapon/melee/sword/sword_01.iff	generic_collectible
object/weapon/melee/sword/sword_01_npe.iff	generic_collectible
object/weapon/melee/sword/sword_01_static.iff	generic_collectible
object/weapon/melee/sword/sword_02_generic.iff	generic_collectible
object/weapon/melee/sword/sword_mace_junti_generic.iff	generic_collectible
object/weapon/melee/sword/sword_mandalorian.iff	generic_collectible
object/weapon/melee/sword/sword_rantok_generic.iff	generic_collectible
object/weapon/melee/sword/sword_rebel.iff	generic_collectible
object/weapon/melee/sword/sword_rsf_generic.iff	generic_collectible
object/weapon/ranged/carbine/carbine_alliance_needler.iff	generic_collectible
object/weapon/ranged/carbine/carbine_bothan_bola_generic.iff	generic_collectible
object/weapon/ranged/carbine/carbine_cdef_npe.iff	generic_collectible
object/weapon/ranged/carbine/carbine_dh17.iff	generic_collectible
object/weapon/ranged/carbine/carbine_dh17_black_npe.iff	generic_collectible
object/weapon/ranged/carbine/carbine_dh17_snubnose_npe.iff	generic_collectible
object/weapon/ranged/carbine/carbine_e11.iff	generic_collectible
object/weapon/ranged/carbine/carbine_e11_static.iff	generic_collectible
object/weapon/ranged/carbine/carbine_e5_generic.iff	generic_collectible
object/weapon/ranged/carbine/carbine_ee3_static.iff	generic_collectible
object/weapon/ranged/carbine/carbine_geo_generic.iff	generic_collectible
object/weapon/ranged/carbine/carbine_laser_static.iff	generic_collectible
object/weapon/ranged/carbine/carbine_mandalorian.iff	generic_collectible
object/weapon/ranged/carbine/ep3/carbine_wookiee_bowcaster_generic.iff	generic_collectible
object/weapon/ranged/carbine/som_carbine_republic_sfor_generic.iff	generic_collectible
object/weapon/ranged/grenade/grenade_fragmentation_generic.iff	generic_collectible
object/weapon/ranged/heavy/heavy_acid_beam_static.iff	generic_collectible
object/weapon/ranged/heavy/heavy_mandalorian.iff	generic_collectible
object/weapon/ranged/heavy/heavy_rebel.iff	generic_collectible
object/weapon/ranged/heavy/heavy_rocket_launcher_generic.iff	generic_collectible
object/weapon/ranged/heavy/som_lava_cannon_generic.iff	generic_collectible
object/weapon/ranged/heavy/som_republic_flamer_generic.iff	generic_collectible
object/weapon/ranged/pistol/pistol_alliance_disruptor.iff	generic_collectible
object/weapon/ranged/pistol/pistol_cdef_npe.iff	generic_collectible
object/weapon/ranged/pistol/pistol_d18.iff	generic_collectible
object/weapon/ranged/pistol/pistol_d18.iff	generic_collectible
object/weapon/ranged/pistol/pistol_d18_npe.iff	generic_collectible
object/weapon/ranged/pistol/pistol_de_10_generic.iff	generic_collectible
object/weapon/ranged/pistol/pistol_dh17_generic.iff	generic_collectible
object/weapon/ranged/pistol/pistol_dl44_metal_static.iff	generic_collectible
object/weapon/ranged/pistol/pistol_flechette_generic.iff	generic_collectible
object/weapon/ranged/pistol/pistol_intimidator_generic.iff	generic_collectible
object/weapon/ranged/pistol/pistol_kyd21_generic.iff	generic_collectible
object/weapon/ranged/pistol/pistol_mandalorian.iff	generic_collectible
object/weapon/ranged/pistol/pistol_rebel.iff	generic_collectible
object/weapon/ranged/pistol/pistol_renegade_generic.iff	generic_collectible
object/weapon/ranged/pistol/pistol_scatter_generic.iff	generic_collectible
object/weapon/ranged/pistol/pistol_scout_blaster_npe.iff	generic_collectible
object/weapon/ranged/pistol/pistol_scout_blaster_static.iff	generic_collectible
object/weapon/ranged/pistol/pistol_striker_static.iff	generic_collectible
object/weapon/ranged/pistol/som_disruptor_pistol_generic.iff	generic_collectible
object/weapon/ranged/pistol/som_ion_relic_pistol_generic.iff	generic_collectible
object/weapon/ranged/rifle/rifle_alliance_gauss_generic.iff	generic_collectible
object/weapon/ranged/rifle/rifle_cdef_npe.iff	generic_collectible
object/weapon/ranged/rifle/rifle_dlt20.iff	generic_collectible
object/weapon/ranged/rifle/rifle_dlt20_npe.iff	generic_collectible
object/weapon/ranged/rifle/rifle_e11_generic.iff	generic_collectible
object/weapon/ranged/rifle/rifle_geo_drill_generic.iff	generic_collectible
object/weapon/ranged/rifle/rifle_ld1_generic.iff	generic_collectible
object/weapon/ranged/rifle/rifle_lightning_heavy_static.iff	generic_collectible
object/weapon/ranged/rifle/rifle_mandalorian.iff	generic_collectible
object/weapon/ranged/rifle/rifle_massassi_ink_generic.iff	generic_collectible
object/weapon/ranged/rifle/rifle_rebel.iff	generic_collectible
object/weapon/ranged/rifle/rifle_sg82_npe.iff	generic_collectible
object/weapon/ranged/rifle/rifle_t21_generic.iff	generic_collectible
object/weapon/ranged/rifle/rifle_tusken.iff	generic_collectible
object/weapon/ranged/rifle/som_rifle_dp23_generic.iff	generic_collectible
object/weapon/ranged/rifle/som_rifle_mustafar_disruptor_generic.iff	generic_collectible
object/tangible/loot/creature_loot/collections/aurebesh_tile_aurek.iff	"generic_collectible,housing_collectible,contraband_collectible"
object/tangible/loot/creature_loot/collections/aurebesh_tile_besh.iff	"generic_collectible,housing_collectible,contraband_collectible"
object/tangible/loot/creature_loot/collections/aurebesh_tile_cherek.iff	"generic_collectible,housing_collectible,contraband_collectible"
object/tangible/loot/creature_loot/collections/aurebesh_tile_cresh.iff	"generic_collectible,housing_collectible,contraband_collectible"
object/tangible/loot/creature_loot/collections/aurebesh_tile_dorn.iff	"generic_collectible,housing_collectible,contraband_collectible"
object/tangible/loot/creature_loot/collections/aurebesh_tile_enth.iff	"generic_collectible,housing_collectible,contraband_collectible"
object/tangible/loot/creature_loot/collections/aurebesh_tile_esk.iff	"generic_collectible,housing_collectible,contraband_collectible"
object/tangible/loot/creature_loot/collections/aurebesh_tile_forn.iff	"generic_collectible,housing_collectible,contraband_collectible"
object/tangible/loot/creature_loot/collections/aurebesh_tile_grek.iff	"generic_collectible,housing_collectible,contraband_collectible"
object/tangible/loot/creature_loot/collections/aurebesh_tile_herf.iff	"generic_collectible,housing_collectible,contraband_collectible"
object/tangible/loot/creature_loot/collections/aurebesh_tile_isk.iff	"generic_collectible,housing_collectible,contraband_collectible"
object/tangible/loot/creature_loot/collections/aurebesh_tile_jenth.iff	"generic_collectible,housing_collectible,contraband_collectible"
object/tangible/loot/creature_loot/collections/aurebesh_tile_kerenth.iff	"generic_collectible,housing_collectible,contraband_collectible"
object/tangible/loot/creature_loot/collections/aurebesh_tile_krill.iff	"generic_collectible,housing_collectible,contraband_collectible"
object/tangible/loot/creature_loot/collections/aurebesh_tile_leth.iff	"generic_collectible,housing_collectible,contraband_collectible"
object/tangible/loot/creature_loot/collections/aurebesh_tile_mern.iff	"generic_collectible,housing_collectible,contraband_collectible"
object/tangible/loot/creature_loot/collections/aurebesh_tile_nen.iff	"generic_collectible,housing_collectible,contraband_collectible"
object/tangible/loot/creature_loot/collections/aurebesh_tile_nern.iff	"generic_collectible,housing_collectible,contraband_collectible"
object/tangible/loot/creature_loot/collections/aurebesh_tile_onith.iff	"generic_collectible,housing_collectible,contraband_collectible"
object/tangible/loot/creature_loot/collections/aurebesh_tile_orenth.iff	"generic_collectible,housing_collectible,contraband_collectible"
object/tangible/loot/creature_loot/collections/aurebesh_tile_osk.iff	"generic_collectible,housing_collectible,contraband_collectible"
object/tangible/loot/creature_loot/collections/aurebesh_tile_peth.iff	"generic_collectible,housing_collectible,contraband_collectible"
object/tangible/loot/creature_loot/collections/aurebesh_tile_qek.iff	"generic_collectible,housing_collectible,contraband_collectible"
object/tangible/loot/creature_loot/collections/aurebesh_tile_resh.iff	"generic_collectible,housing_collectible,contraband_collectible"
object/tangible/loot/creature_loot/collections/aurebesh_tile_senth.iff	"generic_collectible,housing_collectible,contraband_collectible"
object/tangible/loot/creature_loot/collections/aurebesh_tile_shen.iff	"generic_collectible,housing_collectible,contraband_collectible"
object/tangible/loot/creature_loot/collections/aurebesh_tile_thesh.iff	"generic_collectible,housing_collectible,contraband_collectible"
object/tangible/loot/creature_loot/collections/aurebesh_tile_trill.iff	"generic_collectible,housing_collectible,contraband_collectible"
object/tangible/loot/creature_loot/collections/aurebesh_tile_usk.iff	"generic_collectible,housing_collectible,contraband_collectible"
object/tangible/loot/creature_loot/collections/aurebesh_tile_vev.iff	"generic_collectible,housing_collectible,contraband_collectible"
object/tangible/loot/creature_loot/collections/aurebesh_tile_wesk.iff	"generic_collectible,housing_collectible,contraband_collectible"
object/tangible/loot/creature_loot/collections/aurebesh_tile_xesh.iff	"generic_collectible,housing_collectible,contraband_collectible"
object/tangible/loot/creature_loot/collections/aurebesh_tile_yirt.iff	"generic_collectible,housing_collectible,contraband_collectible"
object/tangible/loot/creature_loot/collections/aurebesh_tile_zerek.iff	"generic_collectible,housing_collectible,contraband_collectible"
object/tangible/loot/creature_loot/collections/bantha_bone.iff	dejarik_collectible
object/tangible/loot/creature_loot/collections/col_glass_shelf_book_01.iff	dejarik_collectible
object/tangible/loot/creature_loot/collections/col_imperial_logo_patch.iff	rebel_logo_patch_collectible
object/tangible/loot/creature_loot/collections/col_imperial_rank_col.iff	rebel_officer_rank_collectible
object/tangible/loot/creature_loot/collections/col_imperial_rank_cpt.iff	rebel_officer_rank_collectible
object/tangible/loot/creature_loot/collections/col_imperial_rank_gen.iff	rebel_officer_rank_collectible
object/tangible/loot/creature_loot/collections/col_imperial_rank_lt.iff	rebel_officer_rank_collectible
object/tangible/loot/creature_loot/collections/col_imperial_rank_ltcol.iff	rebel_officer_rank_collectible
object/tangible/loot/creature_loot/collections/col_imperial_rank_maj.iff	rebel_officer_rank_collectible
object/tangible/loot/creature_loot/collections/col_lightsaber_1h_01.iff	rebel_officer_rank_collectible
object/tangible/loot/creature_loot/collections/col_meatlump_rank_01.iff	"trinket_collectible,generic_collectible"
object/tangible/loot/creature_loot/collections/col_meatlump_rank_02.iff	"trinket_collectible,generic_collectible"
object/tangible/loot/creature_loot/collections/col_meatlump_rank_03.iff	"trinket_collectible,generic_collectible"
object/tangible/loot/creature_loot/collections/col_meatlump_rank_04.iff	"trinket_collectible,generic_collectible"
object/tangible/loot/creature_loot/collections/col_meatlump_rank_05.iff	"trinket_collectible,generic_collectible"
object/tangible/loot/creature_loot/collections/col_meatlump_rank_06.iff	"trinket_collectible,generic_collectible"
object/tangible/loot/creature_loot/collections/col_meatlump_rank_07.iff	"trinket_collectible,generic_collectible"
object/tangible/loot/creature_loot/collections/col_meatlump_rank_08.iff	"trinket_collectible,generic_collectible"
object/tangible/loot/creature_loot/collections/col_rebel_logo_patch.iff	imperial_logo_patch_collectible
object/tangible/loot/creature_loot/collections/col_rebel_rank_col.iff	imperial_officer_rank_collectible
object/tangible/loot/creature_loot/collections/col_rebel_rank_com.iff	imperial_officer_rank_collectible
object/tangible/loot/creature_loot/collections/col_rebel_rank_cpt.iff	imperial_officer_rank_collectible
object/tangible/loot/creature_loot/collections/col_rebel_rank_gen.iff	imperial_officer_rank_collectible
object/tangible/loot/creature_loot/collections/col_rebel_rank_lt.iff	imperial_officer_rank_collectible
object/tangible/loot/creature_loot/collections/col_rebel_rank_maj.iff	imperial_officer_rank_collectible
object/tangible/loot/creature_loot/collections/col_treasure_hunter_antique_carbine.iff	treasure_collectible
object/tangible/loot/creature_loot/collections/col_treasure_hunter_antique_melee.iff	treasure_collectible
object/tangible/loot/creature_loot/collections/col_treasure_hunter_antique_pistol.iff	treasure_collectible
object/tangible/loot/creature_loot/collections/col_treasure_hunter_antique_rifle.iff	treasure_collectible
object/tangible/loot/creature_loot/collections/col_treasure_hunter_oval_gem.iff	treasure_collectible
object/tangible/loot/creature_loot/collections/col_treasure_hunter_trilliant_gem.iff	treasure_collectible
object/tangible/loot/creature_loot/collections/contraband_style1_01.iff	housing_collectible
object/tangible/loot/creature_loot/collections/contraband_style1_02.iff	housing_collectible
object/tangible/loot/creature_loot/collections/contraband_style1_03.iff	housing_collectible
object/tangible/loot/creature_loot/collections/contraband_style1_04.iff	housing_collectible
object/tangible/loot/creature_loot/collections/contraband_style1_05.iff	housing_collectible
object/tangible/loot/creature_loot/collections/dejarik_battery.iff	housing_collectible
object/tangible/loot/creature_loot/collections/dejarik_board.iff	housing_collectible
object/tangible/loot/creature_loot/collections/dejarik_ghhhk.iff	housing_collectible
object/tangible/loot/creature_loot/collections/dejarik_grimtaash.iff	housing_collectible
object/tangible/loot/creature_loot/collections/dejarik_holoprojector.iff	housing_collectible
object/tangible/loot/creature_loot/collections/dejarik_houjix.iff	housing_collectible
object/tangible/loot/creature_loot/collections/dejarik_keypad_01.iff	housing_collectible
object/tangible/loot/creature_loot/collections/dejarik_keypad_02.iff	housing_collectible
object/tangible/loot/creature_loot/collections/dejarik_kintan.iff	housing_collectible
object/tangible/loot/creature_loot/collections/dejarik_klorslug.iff	housing_collectible
object/tangible/loot/creature_loot/collections/dejarik_mantellian.iff	housing_collectible
object/tangible/loot/creature_loot/collections/dejarik_monnok.iff	housing_collectible
object/tangible/loot/creature_loot/collections/dejarik_ngok.iff	housing_collectible
object/tangible/loot/creature_loot/collections/dejarik_table_base.iff	housing_collectible
object/tangible/loot/creature_loot/collections/dejarik_table_stand.iff	housing_collectible
object/tangible/loot/creature_loot/collections/dooku_datadisk_01.iff	housing_collectible
object/tangible/loot/creature_loot/collections/dooku_datadisk_02.iff	housing_collectible
object/tangible/loot/creature_loot/collections/dooku_datadisk_03.iff	housing_collectible
object/tangible/loot/creature_loot/collections/dooku_datadisk_04.iff	housing_collectible
object/tangible/loot/creature_loot/collections/dooku_datadisk_05.iff	housing_collectible
object/tangible/loot/creature_loot/collections/exar_kun_lost_journal_page_01.iff	shard_collectible
object/tangible/loot/creature_loot/collections/exar_kun_lost_journal_page_02.iff	shard_collectible
object/tangible/loot/creature_loot/collections/exar_kun_lost_journal_page_03.iff	shard_collectible
object/tangible/loot/creature_loot/collections/exar_kun_lost_journal_page_04.iff	shard_collectible
object/tangible/loot/creature_loot/collections/exar_kun_lost_journal_page_05.iff	shard_collectible
object/tangible/loot/creature_loot/collections/exar_kun_lost_journal_page_06.iff	shard_collectible
object/tangible/loot/creature_loot/collections/exar_kun_lost_journal_page_07.iff	shard_collectible
object/tangible/loot/creature_loot/collections/exar_kun_lost_journal_page_08.iff	shard_collectible
object/tangible/loot/creature_loot/collections/flit_bone.iff	dejarik_collectible
object/tangible/loot/creature_loot/collections/gulginaw_feather.iff	dejarik_collectible
object/tangible/loot/creature_loot/collections/housing_improvement_01.iff	treasure_collectible
object/tangible/loot/creature_loot/collections/housing_improvement_02.iff	treasure_collectible
object/tangible/loot/creature_loot/collections/housing_improvement_03.iff	treasure_collectible
object/tangible/loot/creature_loot/collections/housing_improvement_04.iff	treasure_collectible
object/tangible/loot/creature_loot/collections/housing_improvement_05.iff	treasure_collectible
object/tangible/loot/creature_loot/collections/jedi_holocron_01.iff	holocron_sith
object/tangible/loot/creature_loot/collections/jundank_bone.iff	dejarik_collectible
object/tangible/loot/creature_loot/collections/kai_tok_feather.iff	dejarik_collectible
object/tangible/loot/creature_loot/collections/kill_gurk_activation.iff	dejarik_collectible
object/tangible/loot/creature_loot/collections/kill_kliknik_activation.iff	dejarik_collectible
object/tangible/loot/creature_loot/collections/kill_tulrus_activation.iff	dejarik_collectible
object/tangible/loot/creature_loot/collections/kill_tusken_activation.iff	dejarik_collectible
object/tangible/loot/creature_loot/collections/kima_bone.iff	dejarik_collectible
object/tangible/loot/creature_loot/collections/kwi_bone.iff	dejarik_collectible
object/tangible/loot/creature_loot/collections/mantigrue_feather.iff	dejarik_collectible
object/tangible/loot/creature_loot/collections/meatlump_code_word_01.iff	aurebesh_collectible
object/tangible/loot/creature_loot/collections/meatlump_code_word_02.iff	aurebesh_collectible
object/tangible/loot/creature_loot/collections/meatlump_code_word_03.iff	aurebesh_collectible
object/tangible/loot/creature_loot/collections/meatlump_code_word_04.iff	aurebesh_collectible
object/tangible/loot/creature_loot/collections/meatlump_code_word_05.iff	aurebesh_collectible
object/tangible/loot/creature_loot/collections/meatlump_code_word_06.iff	aurebesh_collectible
object/tangible/loot/creature_loot/collections/meatlump_code_word_07.iff	aurebesh_collectible
object/tangible/loot/creature_loot/collections/meatlump_code_word_08.iff	aurebesh_collectible
object/tangible/loot/creature_loot/collections/meatlump_code_word_09.iff	aurebesh_collectible
object/tangible/loot/creature_loot/collections/meatlump_code_word_10.iff	aurebesh_collectible
object/tangible/loot/creature_loot/collections/meatlump_hench_doll_arm.iff	trinket_collectible
object/tangible/loot/creature_loot/collections/meatlump_hench_doll_head.iff	trinket_collectible
object/tangible/loot/creature_loot/collections/meatlump_hench_doll_leg.iff	trinket_collectible
object/tangible/loot/creature_loot/collections/meatlump_hench_doll_stuffing.iff	trinket_collectible
object/tangible/loot/creature_loot/collections/meatlump_king_doll_arm.iff	trinket_collectible
object/tangible/loot/creature_loot/collections/meatlump_king_doll_head.iff	trinket_collectible
object/tangible/loot/creature_loot/collections/meatlump_king_doll_leg.iff	trinket_collectible
object/tangible/loot/creature_loot/collections/meatlump_king_doll_stuffing.iff	trinket_collectible
object/tangible/loot/creature_loot/collections/meatlump_lint_01.iff	aurebesh_collectible
object/tangible/loot/creature_loot/collections/meatlump_lint_02.iff	aurebesh_collectible
object/tangible/loot/creature_loot/collections/meatlump_lint_03.iff	aurebesh_collectible
object/tangible/loot/creature_loot/collections/meatlump_lint_04.iff	aurebesh_collectible
object/tangible/loot/creature_loot/collections/meatlump_lint_05.iff	aurebesh_collectible
object/tangible/loot/creature_loot/collections/meatlump_lint_06.iff	aurebesh_collectible
object/tangible/loot/creature_loot/collections/meatlump_lint_07.iff	aurebesh_collectible
object/tangible/loot/creature_loot/collections/meatlump_lint_08.iff	aurebesh_collectible
object/tangible/loot/creature_loot/collections/meatlump_lint_09.iff	aurebesh_collectible
object/tangible/loot/creature_loot/collections/meatlump_lint_10.iff	aurebesh_collectible
object/tangible/loot/creature_loot/collections/meatlump_newspaper_01.iff	dejarik_collectible
object/tangible/loot/creature_loot/collections/meatlump_newspaper_02.iff	dejarik_collectible
object/tangible/loot/creature_loot/collections/meatlump_newspaper_03.iff	dejarik_collectible
object/tangible/loot/creature_loot/collections/meatlump_newspaper_04.iff	dejarik_collectible
object/tangible/loot/creature_loot/collections/meatlump_newspaper_05.iff	dejarik_collectible
object/tangible/loot/creature_loot/collections/meatlump_newspaper_06.iff	dejarik_collectible
object/tangible/loot/creature_loot/collections/meatlump_newspaper_07.iff	dejarik_collectible
object/tangible/loot/creature_loot/collections/meatlump_newspaper_08.iff	dejarik_collectible
object/tangible/loot/creature_loot/collections/meatlump_newspaper_09.iff	dejarik_collectible
object/tangible/loot/creature_loot/collections/meatlump_newspaper_10.iff	dejarik_collectible
object/tangible/loot/creature_loot/collections/meatlump_officer_doll_arm.iff	trinket_collectible
object/tangible/loot/creature_loot/collections/meatlump_officer_doll_head.iff	trinket_collectible
object/tangible/loot/creature_loot/collections/meatlump_officer_doll_leg.iff	trinket_collectible
object/tangible/loot/creature_loot/collections/meatlump_officer_doll_stuffing.iff	trinket_collectible
object/tangible/loot/creature_loot/collections/meatlump_uniform_piece_01.iff	housing_collectible
object/tangible/loot/creature_loot/collections/meatlump_uniform_piece_02.iff	housing_collectible
object/tangible/loot/creature_loot/collections/meatlump_uniform_piece_03.iff	housing_collectible
object/tangible/loot/creature_loot/collections/meatlump_uniform_piece_04.iff	housing_collectible
object/tangible/loot/creature_loot/collections/meatlump_uniform_piece_05.iff	housing_collectible
object/tangible/loot/creature_loot/collections/naglatch_bone.iff	dejarik_collectible
object/tangible/loot/creature_loot/collections/nightsister_bracelet.iff	housing_collectible
object/tangible/loot/creature_loot/collections/nightsister_broach.iff	housing_collectible
object/tangible/loot/creature_loot/collections/nightsister_earrings.iff	housing_collectible
object/tangible/loot/creature_loot/collections/nightsister_pendant.iff	housing_collectible
object/tangible/loot/creature_loot/collections/nightsister_ring.iff	housing_collectible
object/tangible/loot/creature_loot/collections/peko_peko_feather.iff	dejarik_collectible
object/tangible/loot/creature_loot/collections/perlek_feather.iff	dejarik_collectible
object/tangible/loot/creature_loot/collections/pugoriss_bone.iff	dejarik_collectible
object/tangible/loot/creature_loot/collections/rancor_bone.iff	dejarik_collectible
object/tangible/loot/creature_loot/collections/rancor_entrails.iff	dejarik_collectible
object/tangible/loot/creature_loot/collections/rancor_eye.iff	dejarik_collectible
object/tangible/loot/creature_loot/collections/rancor_fang.iff	dejarik_collectible
object/tangible/loot/creature_loot/collections/rancor_finger.iff	dejarik_collectible
object/tangible/loot/creature_loot/collections/razor_cat_bone.iff	dejarik_collectible
object/tangible/loot/creature_loot/collections/sith_holocron_01.iff	holocron_jedi
object/tangible/loot/creature_loot/collections/skreeg_bone.iff	dejarik_collectible
object/tangible/loot/creature_loot/collections/space/booster_mark_01_incom.iff	"space_capacitor_collectible,space_engine_collectible,space_reactor_collectible"
object/tangible/loot/creature_loot/collections/space/booster_mark_01_kessel.iff	"space_capacitor_collectible,space_engine_collectible,space_reactor_collectible"
object/tangible/loot/creature_loot/collections/space/booster_mark_01_koensayr.iff	"space_capacitor_collectible,space_engine_collectible,space_reactor_collectible"
object/tangible/loot/creature_loot/collections/space/booster_mark_01_kse.iff	"space_capacitor_collectible,space_engine_collectible,space_reactor_collectible"
object/tangible/loot/creature_loot/collections/space/booster_mark_01_mandal.iff	"space_capacitor_collectible,space_engine_collectible,space_reactor_collectible"
object/tangible/loot/creature_loot/collections/space/booster_mark_01_moncal.iff	"space_capacitor_collectible,space_engine_collectible,space_reactor_collectible"
object/tangible/loot/creature_loot/collections/space/booster_mark_01_novaldex.iff	"space_capacitor_collectible,space_engine_collectible,space_reactor_collectible"
object/tangible/loot/creature_loot/collections/space/booster_mark_01_qualdex.iff	"space_capacitor_collectible,space_engine_collectible,space_reactor_collectible"
object/tangible/loot/creature_loot/collections/space/booster_mark_02_incom.iff	"space_capacitor_collectible,space_engine_collectible,space_reactor_collectible"
object/tangible/loot/creature_loot/collections/space/booster_mark_02_kessel.iff	"space_capacitor_collectible,space_engine_collectible,space_reactor_collectible"
object/tangible/loot/creature_loot/collections/space/booster_mark_02_koensayr.iff	"space_capacitor_collectible,space_engine_collectible,space_reactor_collectible"
object/tangible/loot/creature_loot/collections/space/booster_mark_02_kse.iff	"space_capacitor_collectible,space_engine_collectible,space_reactor_collectible"
object/tangible/loot/creature_loot/collections/space/booster_mark_02_mandal.iff	"space_capacitor_collectible,space_engine_collectible,space_reactor_collectible"
object/tangible/loot/creature_loot/collections/space/booster_mark_02_moncal.iff	"space_capacitor_collectible,space_engine_collectible,space_reactor_collectible"
object/tangible/loot/creature_loot/collections/space/booster_mark_02_novaldex.iff	"space_capacitor_collectible,space_engine_collectible,space_reactor_collectible"
object/tangible/loot/creature_loot/collections/space/booster_mark_02_qualdex.iff	"space_capacitor_collectible,space_engine_collectible,space_reactor_collectible"
object/tangible/loot/creature_loot/collections/space/booster_mark_03_incom.iff	"space_capacitor_collectible,space_engine_collectible,space_reactor_collectible"
object/tangible/loot/creature_loot/collections/space/booster_mark_03_kessel.iff	"space_capacitor_collectible,space_engine_collectible,space_reactor_collectible"
object/tangible/loot/creature_loot/collections/space/booster_mark_03_koensayr.iff	"space_capacitor_collectible,space_engine_collectible,space_reactor_collectible"
object/tangible/loot/creature_loot/collections/space/booster_mark_03_kse.iff	"space_capacitor_collectible,space_engine_collectible,space_reactor_collectible"
object/tangible/loot/creature_loot/collections/space/booster_mark_03_mandal.iff	"space_capacitor_collectible,space_engine_collectible,space_reactor_collectible"
object/tangible/loot/creature_loot/collections/space/booster_mark_03_moncal.iff	"space_capacitor_collectible,space_engine_collectible,space_reactor_collectible"
object/tangible/loot/creature_loot/collections/space/booster_mark_03_novaldex.iff	"space_capacitor_collectible,space_engine_collectible,space_reactor_collectible"
object/tangible/loot/creature_loot/collections/space/booster_mark_03_qualdex.iff	"space_capacitor_collectible,space_engine_collectible,space_reactor_collectible"
object/tangible/loot/creature_loot/collections/space/booster_mark_04_incom.iff	"space_capacitor_collectible,space_engine_collectible,space_reactor_collectible"
object/tangible/loot/creature_loot/collections/space/booster_mark_04_kessel.iff	"space_capacitor_collectible,space_engine_collectible,space_reactor_collectible"
object/tangible/loot/creature_loot/collections/space/booster_mark_04_koensayr.iff	"space_capacitor_collectible,space_engine_collectible,space_reactor_collectible"
object/tangible/loot/creature_loot/collections/space/booster_mark_04_kse.iff	"space_capacitor_collectible,space_engine_collectible,space_reactor_collectible"
object/tangible/loot/creature_loot/collections/space/booster_mark_04_mandal.iff	"space_capacitor_collectible,space_engine_collectible,space_reactor_collectible"
object/tangible/loot/creature_loot/collections/space/booster_mark_04_moncal.iff	"space_capacitor_collectible,space_engine_collectible,space_reactor_collectible"
object/tangible/loot/creature_loot/collections/space/booster_mark_04_novaldex.iff	"space_capacitor_collectible,space_engine_collectible,space_reactor_collectible"
object/tangible/loot/creature_loot/collections/space/booster_mark_04_qualdex.iff	"space_capacitor_collectible,space_engine_collectible,space_reactor_collectible"
object/tangible/loot/creature_loot/collections/space/booster_mark_05_incom.iff	"space_capacitor_collectible,space_engine_collectible,space_reactor_collectible"
object/tangible/loot/creature_loot/collections/space/booster_mark_05_kessel.iff	"space_capacitor_collectible,space_engine_collectible,space_reactor_collectible"
object/tangible/loot/creature_loot/collections/space/booster_mark_05_koensayr.iff	"space_capacitor_collectible,space_engine_collectible,space_reactor_collectible"
object/tangible/loot/creature_loot/collections/space/booster_mark_05_kse.iff	"space_capacitor_collectible,space_engine_collectible,space_reactor_collectible"
object/tangible/loot/creature_loot/collections/space/booster_mark_05_mandal.iff	"space_capacitor_collectible,space_engine_collectible,space_reactor_collectible"
object/tangible/loot/creature_loot/collections/space/booster_mark_05_moncal.iff	"space_capacitor_collectible,space_engine_collectible,space_reactor_collectible"
object/tangible/loot/creature_loot/collections/space/booster_mark_05_novaldex.iff	"space_capacitor_collectible,space_engine_collectible,space_reactor_collectible"
object/tangible/loot/creature_loot/collections/space/booster_mark_05_qualdex.iff	"space_capacitor_collectible,space_engine_collectible,space_reactor_collectible"
object/tangible/loot/creature_loot/collections/space/capacitor_mark_01_corellian.iff	"space_booster_collectible,space_engine_collectible,space_reactor_collectible"
object/tangible/loot/creature_loot/collections/space/capacitor_mark_01_incom.iff	"space_booster_collectible,space_engine_collectible,space_reactor_collectible"
object/tangible/loot/creature_loot/collections/space/capacitor_mark_01_koensayr.iff	"space_booster_collectible,space_engine_collectible,space_reactor_collectible"
object/tangible/loot/creature_loot/collections/space/capacitor_mark_01_kse.iff	"space_booster_collectible,space_engine_collectible,space_reactor_collectible"
object/tangible/loot/creature_loot/collections/space/capacitor_mark_01_mandal.iff	"space_booster_collectible,space_engine_collectible,space_reactor_collectible"
object/tangible/loot/creature_loot/collections/space/capacitor_mark_01_moncal.iff	"space_booster_collectible,space_engine_collectible,space_reactor_collectible"
object/tangible/loot/creature_loot/collections/space/capacitor_mark_01_novaldex.iff	"space_booster_collectible,space_engine_collectible,space_reactor_collectible"
object/tangible/loot/creature_loot/collections/space/capacitor_mark_01_qualdex.iff	"space_booster_collectible,space_engine_collectible,space_reactor_collectible"
object/tangible/loot/creature_loot/collections/space/capacitor_mark_02_corellian.iff	"space_booster_collectible,space_engine_collectible,space_reactor_collectible"
object/tangible/loot/creature_loot/collections/space/capacitor_mark_02_incom.iff	"space_booster_collectible,space_engine_collectible,space_reactor_collectible"
object/tangible/loot/creature_loot/collections/space/capacitor_mark_02_koensayr.iff	"space_booster_collectible,space_engine_collectible,space_reactor_collectible"
object/tangible/loot/creature_loot/collections/space/capacitor_mark_02_kse.iff	"space_booster_collectible,space_engine_collectible,space_reactor_collectible"
object/tangible/loot/creature_loot/collections/space/capacitor_mark_02_mandal.iff	"space_booster_collectible,space_engine_collectible,space_reactor_collectible"
object/tangible/loot/creature_loot/collections/space/capacitor_mark_02_moncal.iff	"space_booster_collectible,space_engine_collectible,space_reactor_collectible"
object/tangible/loot/creature_loot/collections/space/capacitor_mark_02_novaldex.iff	"space_booster_collectible,space_engine_collectible,space_reactor_collectible"
object/tangible/loot/creature_loot/collections/space/capacitor_mark_02_qualdex.iff	"space_booster_collectible,space_engine_collectible,space_reactor_collectible"
object/tangible/loot/creature_loot/collections/space/capacitor_mark_03_corellian.iff	"space_booster_collectible,space_engine_collectible,space_reactor_collectible"
object/tangible/loot/creature_loot/collections/space/capacitor_mark_03_incom.iff	"space_booster_collectible,space_engine_collectible,space_reactor_collectible"
object/tangible/loot/creature_loot/collections/space/capacitor_mark_03_koensayr.iff	"space_booster_collectible,space_engine_collectible,space_reactor_collectible"
object/tangible/loot/creature_loot/collections/space/capacitor_mark_03_kse.iff	"space_booster_collectible,space_engine_collectible,space_reactor_collectible"
object/tangible/loot/creature_loot/collections/space/capacitor_mark_03_mandal.iff	"space_booster_collectible,space_engine_collectible,space_reactor_collectible"
object/tangible/loot/creature_loot/collections/space/capacitor_mark_03_moncal.iff	"space_booster_collectible,space_engine_collectible,space_reactor_collectible"
object/tangible/loot/creature_loot/collections/space/capacitor_mark_03_novaldex.iff	"space_booster_collectible,space_engine_collectible,space_reactor_collectible"
object/tangible/loot/creature_loot/collections/space/capacitor_mark_03_qualdex.iff	"space_booster_collectible,space_engine_collectible,space_reactor_collectible"
object/tangible/loot/creature_loot/collections/space/capacitor_mark_04_corellian.iff	"space_booster_collectible,space_engine_collectible,space_reactor_collectible"
object/tangible/loot/creature_loot/collections/space/capacitor_mark_04_incom.iff	"space_booster_collectible,space_engine_collectible,space_reactor_collectible"
object/tangible/loot/creature_loot/collections/space/capacitor_mark_04_koensayr.iff	"space_booster_collectible,space_engine_collectible,space_reactor_collectible"
object/tangible/loot/creature_loot/collections/space/capacitor_mark_04_kse.iff	"space_booster_collectible,space_engine_collectible,space_reactor_collectible"
object/tangible/loot/creature_loot/collections/space/capacitor_mark_04_mandal.iff	"space_booster_collectible,space_engine_collectible,space_reactor_collectible"
object/tangible/loot/creature_loot/collections/space/capacitor_mark_04_moncal.iff	"space_booster_collectible,space_engine_collectible,space_reactor_collectible"
object/tangible/loot/creature_loot/collections/space/capacitor_mark_04_novaldex.iff	"space_booster_collectible,space_engine_collectible,space_reactor_collectible"
object/tangible/loot/creature_loot/collections/space/capacitor_mark_04_qualdex.iff	"space_booster_collectible,space_engine_collectible,space_reactor_collectible"
object/tangible/loot/creature_loot/collections/space/capacitor_mark_05_corellian.iff	"space_booster_collectible,space_engine_collectible,space_reactor_collectible"
object/tangible/loot/creature_loot/collections/space/capacitor_mark_05_incom.iff	"space_booster_collectible,space_engine_collectible,space_reactor_collectible"
object/tangible/loot/creature_loot/collections/space/capacitor_mark_05_koensayr.iff	"space_booster_collectible,space_engine_collectible,space_reactor_collectible"
object/tangible/loot/creature_loot/collections/space/capacitor_mark_05_kse.iff	"space_booster_collectible,space_engine_collectible,space_reactor_collectible"
object/tangible/loot/creature_loot/collections/space/capacitor_mark_05_mandal.iff	"space_booster_collectible,space_engine_collectible,space_reactor_collectible"
object/tangible/loot/creature_loot/collections/space/capacitor_mark_05_moncal.iff	"space_booster_collectible,space_engine_collectible,space_reactor_collectible"
object/tangible/loot/creature_loot/collections/space/capacitor_mark_05_novaldex.iff	"space_booster_collectible,space_engine_collectible,space_reactor_collectible"
object/tangible/loot/creature_loot/collections/space/capacitor_mark_05_qualdex.iff	"space_booster_collectible,space_engine_collectible,space_reactor_collectible"
object/tangible/loot/creature_loot/collections/space/engine_mark_01_cygnus.iff	"space_booster_collectible,space_capacitor_collectible,space_reactor_collectible"
object/tangible/loot/creature_loot/collections/space/engine_mark_01_incom.iff	"space_booster_collectible,space_capacitor_collectible,space_reactor_collectible"
object/tangible/loot/creature_loot/collections/space/engine_mark_01_koensayr.iff	"space_booster_collectible,space_capacitor_collectible,space_reactor_collectible"
object/tangible/loot/creature_loot/collections/space/engine_mark_01_kse.iff	"space_booster_collectible,space_capacitor_collectible,space_reactor_collectible"
object/tangible/loot/creature_loot/collections/space/engine_mark_01_mandal.iff	"space_booster_collectible,space_capacitor_collectible,space_reactor_collectible"
object/tangible/loot/creature_loot/collections/space/engine_mark_01_moncal.iff	"space_booster_collectible,space_capacitor_collectible,space_reactor_collectible"
object/tangible/loot/creature_loot/collections/space/engine_mark_01_novaldex.iff	"space_booster_collectible,space_capacitor_collectible,space_reactor_collectible"
object/tangible/loot/creature_loot/collections/space/engine_mark_01_qualdex.iff	"space_booster_collectible,space_capacitor_collectible,space_reactor_collectible"
object/tangible/loot/creature_loot/collections/space/engine_mark_02_cygnus.iff	"space_booster_collectible,space_capacitor_collectible,space_reactor_collectible"
object/tangible/loot/creature_loot/collections/space/engine_mark_02_incom.iff	"space_booster_collectible,space_capacitor_collectible,space_reactor_collectible"
object/tangible/loot/creature_loot/collections/space/engine_mark_02_koensayr.iff	"space_booster_collectible,space_capacitor_collectible,space_reactor_collectible"
object/tangible/loot/creature_loot/collections/space/engine_mark_02_kse.iff	"space_booster_collectible,space_capacitor_collectible,space_reactor_collectible"
object/tangible/loot/creature_loot/collections/space/engine_mark_02_mandal.iff	"space_booster_collectible,space_capacitor_collectible,space_reactor_collectible"
object/tangible/loot/creature_loot/collections/space/engine_mark_02_moncal.iff	"space_booster_collectible,space_capacitor_collectible,space_reactor_collectible"
object/tangible/loot/creature_loot/collections/space/engine_mark_02_novaldex.iff	"space_booster_collectible,space_capacitor_collectible,space_reactor_collectible"
object/tangible/loot/creature_loot/collections/space/engine_mark_02_qualdex.iff	"space_booster_collectible,space_capacitor_collectible,space_reactor_collectible"
object/tangible/loot/creature_loot/collections/space/engine_mark_03_cygnus.iff	"space_booster_collectible,space_capacitor_collectible,space_reactor_collectible"
object/tangible/loot/creature_loot/collections/space/engine_mark_03_incom.iff	"space_booster_collectible,space_capacitor_collectible,space_reactor_collectible"
object/tangible/loot/creature_loot/collections/space/engine_mark_03_koensayr.iff	"space_booster_collectible,space_capacitor_collectible,space_reactor_collectible"
object/tangible/loot/creature_loot/collections/space/engine_mark_03_kse.iff	"space_booster_collectible,space_capacitor_collectible,space_reactor_collectible"
object/tangible/loot/creature_loot/collections/space/engine_mark_03_mandal.iff	"space_booster_collectible,space_capacitor_collectible,space_reactor_collectible"
object/tangible/loot/creature_loot/collections/space/engine_mark_03_moncal.iff	"space_booster_collectible,space_capacitor_collectible,space_reactor_collectible"
object/tangible/loot/creature_loot/collections/space/engine_mark_03_novaldex.iff	"space_booster_collectible,space_capacitor_collectible,space_reactor_collectible"
object/tangible/loot/creature_loot/collections/space/engine_mark_03_qualdex.iff	"space_booster_collectible,space_capacitor_collectible,space_reactor_collectible"
object/tangible/loot/creature_loot/collections/space/engine_mark_04_cygnus.iff	"space_booster_collectible,space_capacitor_collectible,space_reactor_collectible"
object/tangible/loot/creature_loot/collections/space/engine_mark_04_incom.iff	"space_booster_collectible,space_capacitor_collectible,space_reactor_collectible"
object/tangible/loot/creature_loot/collections/space/engine_mark_04_koensayr.iff	"space_booster_collectible,space_capacitor_collectible,space_reactor_collectible"
object/tangible/loot/creature_loot/collections/space/engine_mark_04_kse.iff	"space_booster_collectible,space_capacitor_collectible,space_reactor_collectible"
object/tangible/loot/creature_loot/collections/space/engine_mark_04_mandal.iff	"space_booster_collectible,space_capacitor_collectible,space_reactor_collectible"
object/tangible/loot/creature_loot/collections/space/engine_mark_04_moncal.iff	"space_booster_collectible,space_capacitor_collectible,space_reactor_collectible"
object/tangible/loot/creature_loot/collections/space/engine_mark_04_novaldex.iff	"space_booster_collectible,space_capacitor_collectible,space_reactor_collectible"
object/tangible/loot/creature_loot/collections/space/engine_mark_04_qualdex.iff	"space_booster_collectible,space_capacitor_collectible,space_reactor_collectible"
object/tangible/loot/creature_loot/collections/space/engine_mark_05_cygnus.iff	"space_booster_collectible,space_capacitor_collectible,space_reactor_collectible"
object/tangible/loot/creature_loot/collections/space/engine_mark_05_incom.iff	"space_booster_collectible,space_capacitor_collectible,space_reactor_collectible"
object/tangible/loot/creature_loot/collections/space/engine_mark_05_koensayr.iff	"space_booster_collectible,space_capacitor_collectible,space_reactor_collectible"
object/tangible/loot/creature_loot/collections/space/engine_mark_05_kse.iff	"space_booster_collectible,space_capacitor_collectible,space_reactor_collectible"
object/tangible/loot/creature_loot/collections/space/engine_mark_05_mandal.iff	"space_booster_collectible,space_capacitor_collectible,space_reactor_collectible"
object/tangible/loot/creature_loot/collections/space/engine_mark_05_moncal.iff	"space_booster_collectible,space_capacitor_collectible,space_reactor_collectible"
object/tangible/loot/creature_loot/collections/space/engine_mark_05_novaldex.iff	"space_booster_collectible,space_capacitor_collectible,space_reactor_collectible"
object/tangible/loot/creature_loot/collections/space/engine_mark_05_qualdex.iff	"space_booster_collectible,space_capacitor_collectible,space_reactor_collectible"
object/tangible/loot/creature_loot/collections/space/reactor_mark_01_cygnus.iff	"space_booster_collectible,space_capacitor_collectible,space_engine_collectible"
object/tangible/loot/creature_loot/collections/space/reactor_mark_01_freitek.iff	"space_booster_collectible,space_capacitor_collectible,space_engine_collectible"
object/tangible/loot/creature_loot/collections/space/reactor_mark_01_incom.iff	"space_booster_collectible,space_capacitor_collectible,space_engine_collectible"
object/tangible/loot/creature_loot/collections/space/reactor_mark_01_koensayr.iff	"space_booster_collectible,space_capacitor_collectible,space_engine_collectible"
object/tangible/loot/creature_loot/collections/space/reactor_mark_01_kse.iff	"space_booster_collectible,space_capacitor_collectible,space_engine_collectible"
object/tangible/loot/creature_loot/collections/space/reactor_mark_01_mandal.iff	"space_booster_collectible,space_capacitor_collectible,space_engine_collectible"
object/tangible/loot/creature_loot/collections/space/reactor_mark_01_seinar.iff	"space_booster_collectible,space_capacitor_collectible,space_engine_collectible"
object/tangible/loot/creature_loot/collections/space/reactor_mark_01_subpro.iff	"space_booster_collectible,space_capacitor_collectible,space_engine_collectible"
object/tangible/loot/creature_loot/collections/space/reactor_mark_02_cygnus.iff	"space_booster_collectible,space_capacitor_collectible,space_engine_collectible"
object/tangible/loot/creature_loot/collections/space/reactor_mark_02_freitek.iff	"space_booster_collectible,space_capacitor_collectible,space_engine_collectible"
object/tangible/loot/creature_loot/collections/space/reactor_mark_02_incom.iff	"space_booster_collectible,space_capacitor_collectible,space_engine_collectible"
object/tangible/loot/creature_loot/collections/space/reactor_mark_02_koensayr.iff	"space_booster_collectible,space_capacitor_collectible,space_engine_collectible"
object/tangible/loot/creature_loot/collections/space/reactor_mark_02_kse.iff	"space_booster_collectible,space_capacitor_collectible,space_engine_collectible"
object/tangible/loot/creature_loot/collections/space/reactor_mark_02_mandal.iff	"space_booster_collectible,space_capacitor_collectible,space_engine_collectible"
object/tangible/loot/creature_loot/collections/space/reactor_mark_02_seinar.iff	"space_booster_collectible,space_capacitor_collectible,space_engine_collectible"
object/tangible/loot/creature_loot/collections/space/reactor_mark_02_subpro.iff	"space_booster_collectible,space_capacitor_collectible,space_engine_collectible"
object/tangible/loot/creature_loot/collections/space/reactor_mark_03_cygnus.iff	"space_booster_collectible,space_capacitor_collectible,space_engine_collectible"
object/tangible/loot/creature_loot/collections/space/reactor_mark_03_freitek.iff	"space_booster_collectible,space_capacitor_collectible,space_engine_collectible"
object/tangible/loot/creature_loot/collections/space/reactor_mark_03_incom.iff	"space_booster_collectible,space_capacitor_collectible,space_engine_collectible"
object/tangible/loot/creature_loot/collections/space/reactor_mark_03_koensayr.iff	"space_booster_collectible,space_capacitor_collectible,space_engine_collectible"
object/tangible/loot/creature_loot/collections/space/reactor_mark_03_kse.iff	"space_booster_collectible,space_capacitor_collectible,space_engine_collectible"
object/tangible/loot/creature_loot/collections/space/reactor_mark_03_mandal.iff	"space_booster_collectible,space_capacitor_collectible,space_engine_collectible"
object/tangible/loot/creature_loot/collections/space/reactor_mark_03_seinar.iff	"space_booster_collectible,space_capacitor_collectible,space_engine_collectible"
object/tangible/loot/creature_loot/collections/space/reactor_mark_03_subpro.iff	"space_booster_collectible,space_capacitor_collectible,space_engine_collectible"
object/tangible/loot/creature_loot/collections/space/reactor_mark_04_cygnus.iff	"space_booster_collectible,space_capacitor_collectible,space_engine_collectible"
object/tangible/loot/creature_loot/collections/space/reactor_mark_04_freitek.iff	"space_booster_collectible,space_capacitor_collectible,space_engine_collectible"
object/tangible/loot/creature_loot/collections/space/reactor_mark_04_incom.iff	"space_booster_collectible,space_capacitor_collectible,space_engine_collectible"
object/tangible/loot/creature_loot/collections/space/reactor_mark_04_koensayr.iff	"space_booster_collectible,space_capacitor_collectible,space_engine_collectible"
object/tangible/loot/creature_loot/collections/space/reactor_mark_04_kse.iff	"space_booster_collectible,space_capacitor_collectible,space_engine_collectible"
object/tangible/loot/creature_loot/collections/space/reactor_mark_04_mandal.iff	"space_booster_collectible,space_capacitor_collectible,space_engine_collectible"
object/tangible/loot/creature_loot/collections/space/reactor_mark_04_seinar.iff	"space_booster_collectible,space_capacitor_collectible,space_engine_collectible"
object/tangible/loot/creature_loot/collections/space/reactor_mark_04_subpro.iff	"space_booster_collectible,space_capacitor_collectible,space_engine_collectible"
object/tangible/loot/creature_loot/collections/space/reactor_mark_05_cygnus.iff	"space_booster_collectible,space_capacitor_collectible,space_engine_collectible"
object/tangible/loot/creature_loot/collections/space/reactor_mark_05_freitek.iff	"space_booster_collectible,space_capacitor_collectible,space_engine_collectible"
object/tangible/loot/creature_loot/collections/space/reactor_mark_05_incom.iff	"space_booster_collectible,space_capacitor_collectible,space_engine_collectible"
object/tangible/loot/creature_loot/collections/space/reactor_mark_05_koensayr.iff	"space_booster_collectible,space_capacitor_collectible,space_engine_collectible"
object/tangible/loot/creature_loot/collections/space/reactor_mark_05_kse.iff	"space_booster_collectible,space_capacitor_collectible,space_engine_collectible"
object/tangible/loot/creature_loot/collections/space/reactor_mark_05_mandal.iff	"space_booster_collectible,space_capacitor_collectible,space_engine_collectible"
object/tangible/loot/creature_loot/collections/space/reactor_mark_05_seinar.iff	"space_booster_collectible,space_capacitor_collectible,space_engine_collectible"
object/tangible/loot/creature_loot/collections/space/reactor_mark_05_subpro.iff	"space_booster_collectible,space_capacitor_collectible,space_engine_collectible"
object/tangible/loot/creature_loot/collections/swirl_prong_bone.iff	dejarik_collectible
object/tangible/loot/creature_loot/collections/thune_bone.iff	dejarik_collectible
object/tangible/loot/creature_loot/collections/trader_dom_gem_bead.iff	"schematic_reward_01,schematic_reward_02"
object/tangible/loot/creature_loot/collections/trader_dom_gold_bead.iff	"schematic_reward_01,schematic_reward_02"
object/tangible/loot/creature_loot/collections/trader_dom_gold_wire.iff	"schematic_reward_01,schematic_reward_02"
object/tangible/loot/creature_loot/collections/trader_dom_green_bead.iff	"schematic_reward_01,schematic_reward_02"
object/tangible/loot/creature_loot/collections/trader_dom_jewelry_clasp.iff	"schematic_reward_01,schematic_reward_02"
object/tangible/loot/creature_loot/collections/trader_eng_head.iff	"schematic_reward_01,schematic_reward_02"
object/tangible/loot/creature_loot/collections/trader_eng_left_arm.iff	"schematic_reward_01,schematic_reward_02"
object/tangible/loot/creature_loot/collections/trader_eng_left_leg.iff	"schematic_reward_01,schematic_reward_02"
object/tangible/loot/creature_loot/collections/trader_eng_right_arm.iff	"schematic_reward_01,schematic_reward_02"
object/tangible/loot/creature_loot/collections/trader_eng_right_leg.iff	"schematic_reward_01,schematic_reward_02"
object/tangible/loot/creature_loot/collections/trader_eng_stand_base.iff	"schematic_reward_01,schematic_reward_02"
object/tangible/loot/creature_loot/collections/trader_eng_torso.iff	"schematic_reward_01,schematic_reward_02"
object/tangible/loot/creature_loot/collections/trader_mun_head.iff	"schematic_reward_01,schematic_reward_02"
object/tangible/loot/creature_loot/collections/trader_mun_left_arm.iff	"schematic_reward_01,schematic_reward_02"
object/tangible/loot/creature_loot/collections/trader_mun_left_leg.iff	"schematic_reward_01,schematic_reward_02"
object/tangible/loot/creature_loot/collections/trader_mun_right_arm.iff	"schematic_reward_01,schematic_reward_02"
object/tangible/loot/creature_loot/collections/trader_mun_right_leg.iff	"schematic_reward_01,schematic_reward_02"
object/tangible/loot/creature_loot/collections/trader_mun_stand_base.iff	"schematic_reward_01,schematic_reward_02"
object/tangible/loot/creature_loot/collections/trader_mun_torso.iff	"schematic_reward_01,schematic_reward_02"
object/tangible/loot/creature_loot/collections/treasure_hunter_dolovite_mask.iff	housing_collectible
object/tangible/loot/creature_loot/collections/treasure_hunter_hendanyn_mask.iff	housing_collectible
object/tangible/loot/creature_loot/collections/treasure_hunter_mandalore_mask.iff	housing_collectible
object/tangible/loot/creature_loot/collections/treasure_hunter_sith_mask.iff	housing_collectible
object/tangible/loot/creature_loot/collections/tusken_bantha_braid.iff	housing_collectible
object/tangible/loot/creature_loot/collections/tusken_bracelet.iff	housing_collectible
object/tangible/loot/creature_loot/collections/tusken_gaderffi.iff	housing_collectible
object/tangible/loot/creature_loot/collections/tusken_hubba_gourd.iff	housing_collectible
object/tangible/loot/creature_loot/collections/tusken_massif_thorn.iff	housing_collectible
object/tangible/loot/creature_loot/collections/tusken_metal.iff	housing_collectible
object/tangible/loot/creature_loot/collections/tusken_spirit_mask.iff	housing_collectible
object/tangible/loot/creature_loot/collections/tusken_talisman.iff	housing_collectible
object/tangible/loot/creature_loot/collections/tusken_womp_rat_tusk.iff	dejarik_collectible
object/tangible/loot/creature_loot/collections/unknown_shattered_shard_fragment.iff	"damind_collectible,eralam_collectible,kasha_collectible,luxum_collectible"
object/tangible/loot/creature_loot/collections/whisper_bird_feather.iff	dejarik_collectible
