NAME	TYPE	SUBTYPE	OTHER	comments
s	s	s	s	c
absorption_bleeding	skill	absorption_bleeding		HAY U GUZY THIS IS ALPHABETIZED NOW - ORLY
absorption_disease	skill	absorption_disease		
absorption_fire	skill	absorption_fire		
absorption_poison	skill	absorption_poison		
accuracy_modifier	skill	accuracy_modifier		
action	attrib	action		
action_burn	actionBurn	action_burn		
action_regen	actionRegen	N_A		
actionPercent	attribPercent	action		
advanced_assembly	skill	advanced_assembly		
aggro_channel_self	aggroChannel	self		
aggro_channel_target	aggroChannel	target		
agility_modified	skill	agility_modified		
agility_percent	skillPercent	agility_modified		
armor_assembly	skill	armor_assembly
armor_experimentation	skill	armor_experimentation
armor_station	scriptVar	armor_station
attack_override_by_buff	skill	attack_override_by_buff
avoid_incap	skill	avoid_incap
avoid_incap_heal	onIncapHeal	gcw_critical_heal
axkva_contagion	axkvaContagion	axkva_contagion
bh_dire_root	skill	bh_dire_root
bh_dire_snare	skill	bh_dire_snare
bh_fast_arakyd	skill	bh_fast_arakyd
bh_flawless_bead	skill	bh_flawless_bead
bh_flawless_proc_chance	bhFlawless	bh_flawless_proc_chance
bh_flawless_strike	commandGrant	bh_flawless_strike
bh_orbital_arakyd	skill	bh_orbital_arakyd
bh_swift_seeker	skill	bh_swift_seeker
block	skill	block
bm_beast_family_all	bmBeastFamily	all
bm_beast_family_monkey	bmBeastFamily	monkey
bm_beast_family_pig	bmBeastFamily	pig
bm_beast_xp_buff	bmBeastXpBuff	beastXpBonusPercent
bm_xp_mod_boost	skill	bm_xp_mod_boost
booster_assembly	skill	booster_assembly
booster_experimentation	skill	booster_experimentation
buff_purge	immunity	buff_purge
buffing_efficiency	skill	buffing_efficiency
buildabuff	buildabuff	buildabuff
call_for_pickup	callPickupCraft	call_for_pickup
camouflage	skill	camouflage
carbine_accuracy	skill	carbine_accuracy
carbine_speed	skill	carbine_speed
caretaker_debuff_handler	caretakerHandler	caretaker_debuff_handler
channel_heal_health	channelHeal	health
chassis_assembly	skill	chassis_assembly
chassis_experimentation	skill	chassis_experimentation
closed_fist_burn_debuff_handler	closedFistBurnDebuff	closed_fist_burn_debuff_handler
closed_fist_burn_handler	closedFistBurnHandler	closed_fist_burn_handler
clothing_assembly	skill	clothing_assembly
clothing_experimentation	skill	clothing_experimentation
co_enrage_1	commandGrant	co_enrage_1
combat_add_damage_dealt	skill	combat_add_damage_dealt
combat_add_damage_taken	skill	combat_add_damage_taken
combat_all_attack_avoidance	skill	combat_all_attack_avoidance
combat_all_attack_miss	skill	combat_all_attack_miss
combat_all_attack_miss_reduction	skill	combat_all_attack_miss_reduction
combat_all_attack_miss_vulnerability	skill	combat_all_attack_miss_vulnerability
combat_block_chance	skill	combat_block_chance
combat_block_reduction	skill	combat_block_reduction
combat_block_value	skill	combat_block_value
combat_critical_hit	skill	combat_critical_hit
combat_critical_hit_reduction	skill	combat_critical_hit_reduction
combat_divide_damage_dealt	skill	combat_divide_damage_dealt
combat_divide_damage_taken	skill	combat_divide_damage_taken
combat_dodge	skill	combat_dodge
combat_dodge_reduction	skill	combat_dodge_reduction
combat_evasion_chance	skill	combat_evasion_chance
combat_evasion_value	skill	combat_evasion_value
combat_glancing	skill	combat_glancing
combat_glancing_blow_reduction	skill	combat_glancing_blow_reduction
combat_haste	skill	combat_haste
combat_melee_attack_avoidance	skill	combat_melee_attack_avoidance
combat_melee_attack_miss	skill	combat_melee_attack_miss
combat_melee_attack_miss_reduction	skill	combat_melee_attack_miss_reduction
combat_melee_attack_vulnerability	skill	combat_melee_attack_vulnerability
combat_multiply_damage_dealt	skill	combat_multiply_damage_dealt
combat_multiply_damage_taken	skill	combat_multiply_damage_taken
combat_parry	skill	combat_parry
combat_parry_reduction	skill	combat_parry_reduction
combat_ranged_attack_avoidance	skill	combat_ranged_attack_avoidance
combat_ranged_attack_miss	skill	combat_ranged_attack_miss
combat_ranged_attack_miss_reduction	skill	combat_ranged_attack_miss_reduction
combat_ranged_attack_vulnerability	skill	combat_ranged_attack_vulnerability
combat_slow	skill	combat_slow
combat_strikethrough_chance	skill	combat_strikethrough_chance
combat_strikethrough_value	skill	combat_strikethrough_value
combat_stun	combatStun	combat_stun
combat_subtract_damage_dealt	skill	combat_subtract_damage_dealt
combat_subtract_damage_taken	skill	combat_subtract_damage_taken
commando_snare_bonus	commandoSnareBonus	commando_snare_bonus
constitution	attrib	constitution
constitution_modified	skill	constitution_modified
constitution_percent	skillPercent	constitution_modified
constitutionPercent	attribPercent	constitution
cooldown_execute_all	cooldownModify	cooldown_execute_all
cooldown_percent_of_group_buff	skill	cooldown_percent_of_group_buff
craft_bonus_architect	craftBonus	architect
craft_bonus_armorsmith	craftBonus	armorsmith
craft_bonus_artisan	craftBonus	artisan
craft_bonus_bioengineer	craftBonus	bioengineer
craft_bonus_chef	craftBonus	chef
craft_bonus_droidengineer	craftBonus	droidengineer
craft_bonus_shipwright	craftBonus	shipwright
craft_bonus_tailor	craftBonus	tailor
craft_bonus_weaponsmith	craftBonus	weaponsmith
creature_harvesting	skill	creature_harvesting
creature_hit_bonus	skill	creature_hit_bonus
crit_acid_dot	dot	acid
crit_cold_dot	dot	cold
crit_electricity_dot	dot	electricity
crit_energy_dot	dot	energy
crit_fire_dot	dot	fire
critical_hit_vulnerable	skill	critical_hit_vulnerable
cure_efficiency	skill	cure_efficiency
cybernetic_assembly	skill	cybernetic_assembly
cybernetic_experimentation	skill	cybernetic_experimentation
damage_dealt_mod	damageDealtMod	damage_dealt_mod
damage_decrease_percentage	skill	damage_decrease_percentage
damage_immune	damageImmune	damage_immune
damage_taken_increase	scriptVar	damage_taken_increase
dance_party	danceParty	dance_party
debuff_purge	immunity	debuff_purge
defense	skill	defense
defense_modifier	skill	defense_modifier
delay_attack	delayAttack	N_A
detect_hidden	skill	detect_hidden
dot_acid	dot	acid
dot_bleed	dot	bleeding
dot_cold	dot	cold
dot_divisor_acid	dotDivisor	dot_divisor_acid
dot_divisor_all	dotDivisor	dot_divisor_all
dot_divisor_bleeding	dotDivisor	dot_divisor_bleeding
dot_divisor_cold	dotDivisor	dot_divisor_cold
dot_divisor_disease	dotDivisor	dot_divisor_disease
dot_divisor_electrical	dotDivisor	dot_divisor_electrical
dot_divisor_elemental	dotDivisor	dot_divisor_elemental
dot_divisor_energy	dotDivisor	dot_divisor_energy
dot_divisor_heat	dotDivisor	dot_divisor_heat
dot_divisor_kinetic	dotDivisor	dot_divisor_kinetic
dot_divisor_natural	dotDivisor	dot_divisor_natural
dot_divisor_poison	dotDivisor	dot_divisor_poison
dot_electricity	dot	electricity
dot_energy	dot	energy
dot_fire	dot	fire
dot_immunity	immunity	dot_immunity
dot_kinetic	dot	kinetic
dot_poison	dot	poison
dot_reduction_acid	dotReduction	dot_reduction_acid
dot_reduction_all	dotReduction	dot_reduction_all
dot_reduction_bleeding	dotReduction	dot_reduction_bleeding
dot_reduction_cold	dotReduction	dot_reduction_cold
dot_reduction_disease	dotReduction	dot_reduction_disease
dot_reduction_electrical	dotReduction	dot_reduction_electrical
dot_reduction_elemental	dotReduction	dot_reduction_elemental
dot_reduction_energy	dotReduction	dot_reduction_energy
dot_reduction_heat	dotReduction	dot_reduction_heat
dot_reduction_kinetic	dotReduction	dot_reduction_kinetic
dot_reduction_natural	dotReduction	dot_reduction_natural
dot_reduction_poison	dotReduction	dot_reduction_poison
dot_resist_acid	skill	dot_resist_acid
dot_resist_all	skill	dot_resist_all
dot_resist_bleeding	skill	dot_resist_bleeding
dot_resist_cold	skill	dot_resist_cold
dot_resist_disease	skill	dot_resist_disease
dot_resist_electrical	skill	dot_resist_electrical
dot_resist_elemental	skill	dot_resist_elemental
dot_resist_energy	skill	dot_resist_energy
dot_resist_heat	skill	dot_resist_heat
dot_resist_kinetic	skill	dot_resist_kinetic
dot_resist_natural	skill	dot_resist_natural
dot_resist_poison	skill	dot_resist_poison
dot_vulnerability_bleed	skill	dot_vulnerability_bleed
droid_assembly	skill	droid_assembly
droid_experimentation	skill	droid_experimentation
droid_track_speed	skill	droid_track_speed
droid_tracks	skill	droid_tracks
dt_vulnerability_acid	vulnerability	dt_vulnerability_acid
dt_vulnerability_cold	vulnerability	dt_vulnerability_cold
dt_vulnerability_electricity	vulnerability	dt_vulnerability_electricity
dt_vulnerability_exclusive_acid	vulnerability	dt_vulnerability_exclusive_acid
dt_vulnerability_exclusive_cold	vulnerability	dt_vulnerability_exclusive_cold
dt_vulnerability_exclusive_electricity	vulnerability	dt_vulnerability_exclusive_electricity
dt_vulnerability_exclusive_heat	vulnerability	dt_vulnerability_exclusive_heat
dt_vulnerability_heat	vulnerability	dt_vulnerability_heat
durni_picture	loopingParticleRoot	pt_durni_camera
engine_assembly	skill	engine_assembly
engine_experimentation	skill	engine_experimentation
enzyme_bonus_mod	forageBonusMod	enzyme
event_halloween_bat_swarm	eventParticle	event_halloween_bat_swarm
event_halloween_costume	costume	event_halloween_costume
event_halloween_trick_cooldown	halloweenCooldown	event_halloween_trick_cooldown
exclude_self	excludeSelf	exclude_self
exclusive_proxy	exclusiveProxy	
exclusive_proxy_of_vortex_root_1	exclusiveProxy	"of_vortex_root,of_vortex_bleed_1"
exclusive_proxy_of_vortex_root_2	exclusiveProxy	"of_vortex_root,of_vortex_bleed_2"
exclusive_proxy_of_vortex_root_3	exclusiveProxy	"of_vortex_root,of_vortex_bleed_3"
exclusive_proxy_of_vortex_root_4	exclusiveProxy	"of_vortex_root,of_vortex_bleed_4"
exclusive_proxy_of_vortex_root_5	exclusiveProxy	"of_vortex_root,of_vortex_bleed_5"
expertise_action_all	skill	expertise_action_all
expertise_action_line_co_grenade	skill	expertise_action_line_co_grenade
expertise_action_line_dm	skill	expertise_action_line_dm
expertise_action_line_dm_crit	skill	expertise_action_line_dm_crit
expertise_action_line_fs_ae_dm_cc	skill	expertise_action_line_fs_ae_dm_cc
expertise_action_line_fs_cc_crit	skill	expertise_action_line_fs_cc_crit
expertise_action_line_fs_dm	skill	expertise_action_line_fs_dm
expertise_action_line_fs_sweep	skill	expertise_action_line_fs_sweep
expertise_action_line_me_burst	skill	expertise_action_line_me_burst
expertise_action_line_me_dm	skill	expertise_action_line_me_dm
expertise_action_line_me_smash	skill	expertise_action_line_me_smash
expertise_action_line_of_aoe	skill	expertise_action_line_of_aoe
expertise_action_line_of_group_buff	skill	expertise_action_line_of_group_buff
expertise_action_line_of_paint	skill	expertise_action_line_of_paint
expertise_action_line_of_sure	skill	expertise_action_line_of_sure
expertise_action_line_sm_dm	skill	expertise_action_line_sm_dm
expertise_action_line_sp_dm	skill	expertise_action_line_sp_dm
expertise_action_line_sp_dot	skill	expertise_action_line_sp_dot
expertise_action_weapon_2	skill	expertise_action_weapon_2
expertise_armor_bypass_fs_ae_dm_cc	skill	expertise_armor_bypass_fs_ae_dm_cc
expertise_attacker_action_gain	skill	expertise_attacker_action_gain
expertise_avoidance_overpower	skill	expertise_avoidance_overpower
expertise_block_chance	skill	expertise_block_chance
expertise_buff_chance_fs_force_throw_root	skill	expertise_buff_chance_fs_force_throw_root
expertise_buff_chance_line_fs_force_throw	skill	expertise_buff_chance_line_fs_force_throw
expertise_buff_duration_line_bh_return_fire	skill	expertise_buff_duration_line_bh_return_fire
expertise_buff_duration_line_me_debuff	skill	expertise_buff_duration_line_me_debuff
expertise_buff_duration_line_me_enhance	skill	expertise_buff_duration_line_me_enhance
expertise_buff_duration_line_sp_preparation	skill	expertise_buff_duration_line_sp_preparation
expertise_channel_action_heal	expertiseChannelActionHeal	expertise_channel_action_heal
expertise_co_burst_fire_proc	skill	expertise_co_burst_fire_proc
expertise_co_killing_spree_target	skill	expertise_co_killing_spree_target
expertise_cooldown_bountycheck	skill	expertise_cooldown_bountycheck
expertise_cooldown_line_bh_detect_camouflage_1	skill	expertise_cooldown_line_bh_detect_camouflage_1
expertise_cooldown_line_bh_flawless_strike	skill	expertise_cooldown_line_bh_flawless_strike
expertise_cooldown_line_bh_return_fire	skill	expertise_cooldown_line_bh_return_fire
expertise_cooldown_line_co_riddle_armor	skill	expertise_cooldown_line_co_riddle_armor
expertise_cooldown_line_dm	skill	expertise_cooldown_line_dm
expertise_cooldown_line_fs_ae_dm_cc	skill	expertise_cooldown_line_fs_ae_dm_cc
expertise_cooldown_line_fs_cc_crit	skill	expertise_cooldown_line_fs_cc_crit
expertise_cooldown_line_fs_dm	skill	expertise_cooldown_line_fs_dm
expertise_cooldown_line_fs_sweep	skill	expertise_cooldown_line_fs_sweep
expertise_cooldown_line_me_dot	skill	expertise_cooldown_line_me_dot
expertise_cooldown_line_me_evasion	skill	expertise_cooldown_line_me_evasion
expertise_cooldown_line_me_stasis_self	skill	expertise_cooldown_line_me_stasis_self
expertise_cooldown_line_of_firepower	skill	expertise_cooldown_line_of_firepower
expertise_cooldown_line_of_paint	skill	expertise_cooldown_line_of_paint
expertise_cooldown_line_of_purge	skill	expertise_cooldown_line_of_purge
expertise_cooldown_line_of_sure	skill	expertise_cooldown_line_of_sure
expertise_cooldown_line_sm_dm	skill	expertise_cooldown_line_sm_dm
expertise_cooldown_line_sm_dm_cc	skill	expertise_cooldown_line_sm_dm_cc
expertise_cooldown_line_sm_false_hope	skill	expertise_cooldown_line_sm_false_hope
expertise_cooldown_line_sp_dm	skill	expertise_cooldown_line_sp_dm
expertise_cooldown_line_sp_preparation	skill	expertise_cooldown_line_sp_preparation
expertise_crit_double_damage	critDoubleDamage	expertise_crit_double_damage
expertise_crit_remove_buff	critOnce	expertise_crit_remove_buff
expertise_crit_root	critRoot	expertise_crit_root
expertise_critical_hit_decrease	skill	expertise_critical_hit_decrease
expertise_critical_hit_pvp_reduction	skill	expertise_critical_hit_pvp_reduction
expertise_critical_hit_reduction	skill	expertise_critical_hit_reduction
expertise_critical_line_of_aoe	skill	expertise_critical_line_of_aoe
expertise_critical_melee	skill	expertise_critical_melee
expertise_critical_niche_all	skill	expertise_critical_niche_all
expertise_critical_ranged	skill	expertise_critical_ranged
expertise_damage_add_to_action	skill	expertise_damage_add_to_action
expertise_damage_all	skill	expertise_damage_all
expertise_damage_decrease_chance	skill	expertise_damage_decrease_chance
expertise_damage_decrease_percentage	expertiseDamageDecrease	expertise_damage_decrease_percentage
expertise_damage_line_of_aoe	skill	expertise_damage_line_of_aoe
expertise_damage_line_vulnerability_sp_hd_melee	skill	expertise_damage_line_vulnerability_sp_hd_melee
expertise_damage_reduce_anticipate_aggression	skill	expertise_damage_reduce_anticipate_aggression
expertise_damage_to_healing_fs_ae_dm_cc	skill	expertise_damage_to_healing_fs_ae_dm_cc
expertise_damage_weapon_0	skill	expertise_damage_weapon_0
expertise_damage_weapon_1	skill	expertise_damage_weapon_1
expertise_damage_weapon_10	skill	expertise_damage_weapon_10
expertise_damage_weapon_11	skill	expertise_damage_weapon_11
expertise_damage_weapon_12	skill	expertise_damage_weapon_12
expertise_damage_weapon_13	skill	expertise_damage_weapon_13
expertise_damage_weapon_2	skill	expertise_damage_weapon_2
expertise_damage_weapon_3	skill	expertise_damage_weapon_3
expertise_damage_weapon_4	skill	expertise_damage_weapon_4
expertise_damage_weapon_5	skill	expertise_damage_weapon_5
expertise_damage_weapon_6	skill	expertise_damage_weapon_6
expertise_damage_weapon_7	skill	expertise_damage_weapon_7
expertise_damage_weapon_8	skill	expertise_damage_weapon_8
expertise_damage_weapon_9	skill	expertise_damage_weapon_9
expertise_devastation_bonus	skill	expertise_devastation_bonus
expertise_dodge	skill	expertise_dodge
expertise_dot_absorption_all	skill	expertise_dot_absorption_all
expertise_dot_immunity	expertiseImmunity	dot_immunity
expertise_en_inspire_buff_duration_increase	skill	expertise_en_inspire_buff_duration_increase
expertise_en_inspire_pulse_duration_increase	skill	expertise_en_inspire_pulse_duration_increase
expertise_evasion_chance	skill	expertise_evasion_chance
expertise_experimentation_increase_architect	skill	expertise_experimentation_increase_architect
expertise_fast_talk	fastTalk	expertise_fast_talk
expertise_flash_bang	commandoFlashBang	expertise_flash_bang
expertise_focus	stance	expertise_focus
expertise_freeshot_co_grenade	skill	expertise_freeshot_co_grenade
expertise_freeshot_me_debuff	skill	expertise_freeshot_me_debuff
expertise_freeshot_me_heal	skill	expertise_freeshot_me_heal
expertise_freeshot_of_aoe	skill	expertise_freeshot_of_aoe
expertise_freeshot_of_sure	skill	expertise_freeshot_of_sure
expertise_freeshot_sm_dm	skill	expertise_freeshot_sm_dm
expertise_freeshot_sm_dm_cc	skill	expertise_freeshot_sm_dm_cc
expertise_freeshot_sp_dm	skill	expertise_freeshot_sp_dm
expertise_glancing_blow_all	skill	expertise_glancing_blow_all
expertise_glancing_blow_melee	skill	expertise_glancing_blow_melee
expertise_glancing_blow_ranged	skill	expertise_glancing_blow_ranged
expertise_healing_all	skill	expertise_healing_all
expertise_healing_line_fs_heal	skill	expertise_healing_line_fs_heal
expertise_healing_reduction	skill	expertise_healing_reduction
expertise_innate_protection_all	skill	expertise_innate_protection_all
expertise_innate_protection_all_mob	skill	expertise_innate_protection_all_mob
expertise_innate_protection_all_player	skill	expertise_innate_protection_all_player
expertise_innate_reduction_all_mob	skill	expertise_innate_reduction_all_mob
expertise_innate_reduction_all_player	skill	expertise_innate_reduction_all_player
expertise_innate_protection_energy	skill	expertise_innate_protection_energy
expertise_innate_protection_kinetic	skill	expertise_innate_protection_kinetic
expertise_innate_protection_cold	skill	expertise_innate_protection_cold
expertise_junk_dealer	junkDealer	expertise_junk_dealer
expertise_lucky_break_chance	skill	expertise_lucky_break_chance
expertise_movement_immunity	expertiseImmunity	movement_immunity
expertise_muscle_spasm	commandoMuscleSpasm	expertise_muscle_spasm
expertise_next_hit_crit	nextHitCrit	expertise_next_hit_crit
expertise_on_target	onTarget	expertise_on_target
expertise_overridable_protection_generic	skill	expertise_overridable_protection_generic
expertise_parry	skill	expertise_parry
expertise_resource_sampling_increase	skill	expertise_resource_sampling_increase
expertise_riddle_armor	commandoRiddleArmor	expertise_riddle_armor
expertise_saber_block	skill	expertise_saber_block
expertise_sly_lie	slyLie	expertise_sly_lie
expertise_sm_rank_damage_bonus	skill	expertise_sm_rank_damage_bonus
expertise_sm_rank_range_bonus	skill	expertise_sm_rank_range_bonus
expertise_spot_a_sucker	spotASucker	expertise_spot_a_sucker
expertise_stance	stance	expertise_stance
expertise_strikethrough_chance	skill	expertise_strikethrough_chance
expertise_target_healing_bonus	skill	expertise_target_healing_bonus
expertise_underworld_boss	skill	expertise_underworld_boss
faction_bonus	scriptVar	faction_bonus
fast_attack_line_co_grenade	skill	fast_attack_line_co_grenade
fast_attack_line_dm_cc	skill	fast_attack_line_dm_cc
fast_attack_line_fs_powers	skill	fast_attack_line_fs_powers
fast_attack_line_me_debuff	skill	fast_attack_line_me_debuff
fast_attack_line_me_dm	skill	fast_attack_line_me_dm
fast_attack_line_me_heal	skill	fast_attack_line_me_heal
fast_attack_line_me_revive	skill	fast_attack_line_me_revive
fast_attack_line_of_aoe	skill	fast_attack_line_of_aoe
fast_attack_line_of_heal	skill	fast_attack_line_of_heal
fast_attack_line_sm_dm	skill	fast_attack_line_sm_dm
fast_attack_line_sm_dm_cc	skill	fast_attack_line_sm_dm_cc
fast_attack_line_sp_dm	skill	fast_attack_line_sp_dm
fast_attack_line_sp_perfect	skill	fast_attack_line_sp_perfect
fast_attack_line_sp_smoke	skill	fast_attack_line_sp_smoke
flawless_bead	skill	flawless_bead
food_assembly	skill	food_assembly
food_experimentation	skill	food_experimentation
food_instant	foodInstant	N_A
food_station	scriptVar	food_station
forage_bonus_mod	skill	forageBonusMod
force_absorb	skill	force_absorb
force_armor	skill	force_armor
force_feedback	skill	force_feedback
force_run	skill	force_run
force_shield	skill	force_shield
forceThrow	forceThrow	forceThrow
freeshot_case_crit	skill	freeshot_case_crit
freeshot_case_dodge	skill	freeshot_case_dodge
freeshot_case_miss	skill	freeshot_case_miss
freeshot_case_parry	skill	freeshot_case_parry
freeshot_case_strikethrough	skill	freeshot_case_strikethrough
fs_choke_handler	fs_choke_handler	fs_choke_handler
fs_flurry_proc	fs_flurry_proc	fs_flurry_proc
fs_set_heroic_taunt_1	commandGrant	fs_set_heroic_taunt_1
general_assembly	skill	general_assembly
general_experimentation	skill	general_experimentation
glancing_blow_vulnerable	skill	glancing_blow_vulnerable
group	group	N_A
group_melee_defense	skill	group_melee_defense
group_ranged_defense	skill	group_ranged_defense
group_slope_move	skill	group_slope_move
healing_action	healEffect	healing_action
healing_dance_wound	skill	healing_dance_wound
healing_efficiency	skill	healing_efficiency
healing_health	healEffect	healing_health
healing_music_wound	skill	healing_music_wound
health	attrib	health
healthPercent	attribPercent	health
heavy_weapon_accuracy	skill	heavy_weapon_accuracy
heavy_weapon_speed	skill	heavy_weapon_speed
hiring	skill	hiring
holoemote_bonus	scriptVar	holoemote_bonus
immediate_action_drain	actionDrain	immediate_action_drain
increase_damage_dealt_to_kun_chaos	skill	increase_damage_dealt_to_kun_chaos
increase_damage_dealt_to_kun_order	skill	increase_damage_dealt_to_kun_order
increase_damage_taken_from_kun_chaos	skill	increase_damage_taken_from_kun_chaos
increase_damage_taken_from_kun_order	skill	increase_damage_taken_from_kun_order
instrument_bonus	scriptVar	instrument_bonus
invis	invisBuff	N_A
jedi_force_power_max	forcePower	jedi_force_power_max
jedi_force_power_regen	forcePower	jedi_force_power_regen
jedi_saber_assembly	skill	jedi_saber_assembly
jedi_saber_experimentation	skill	jedi_saber_experimentation
jedi_statue_dark_debuff_handler	jediStatueDarkDebuff	jedi_statue_dark_debuff_handler
jedi_statue_light_debuff_handler	jediStatueLightDebuff	jedi_statue_light_debuff_handler
krix_resonance	krixResonance	krix_resonance
kun_chaos_handler	kunChaosHandler	kun_chaos_handler
kun_open_spark	kunOpenSpark	kun_open_spark
kun_order_handler	kunOrderHandler	kun_order_handler
luck_modified	skill	luck_modified
luck_percent	skillPercent	luck_modified
luresh_contagion	lureshContagion	luresh_contagion
mask_scent	skill	mask_scent
me_doom	meDoom	me_doom
me_doom_chance	skill	me_doom_chance
medicine_assembly	skill	medicine_assembly
melee_accuracy	skill	melee_accuracy
melee_damage_mod	skill	melee_damage_mod
melee_defense	skill	melee_defense
melee_speed	skill	melee_speed
mind	attrib	mind
mindPercent	attribPercent	mind
movement	movement	N_A
movement_immunity	immunity	movement_immunity
movement_resist_mez	skill	movement_resist_mez
movement_resist_root	skill	movement_resist_root
movement_resist_snare	skill	movement_resist_snare
movement_resist_stun	skill	movement_resist_stun
mtp_meatlump_angry	mtpMeatlumpAngry	mtp_meatlump_angry
mtp_meatlump_happy	mtpMeatlumpHappy	mtp_meatlump_happy
no_break_invis	noBreakInvis	N_A
of_dot_acid	dot	acid
of_dot_fire	dot	fire
of_inspired_action_chance	skill	of_inspired_action_chance
offense	skill	offense
on_attack_remove	onAttackRemove	on_attack_remove
onehandmelee_accuracy	skill	onehandmelee_accuracy
onehandmelee_speed	skill	onehandmelee_speed
pistol_accuracy	skill	pistol_accuracy
pistol_speed	skill	pistol_speed
polearm_accuracy	skill	polearm_accuracy
polearm_speed	skill	polearm_speed
power_systems	skill	power_systems
precision_modified	skill	precision_modified
precision_percent	skillPercent	precision_modified
private_accuracy_bonus	skill	private_accuracy_bonus
private_accuracy_penalty	skill	private_accuracy_penalty
private_armor_bonus	skill	private_armor_bonus
private_armor_break	skill	private_armor_break
private_armor_bypass	skill	private_armor_bypass
private_cooldown_bonus	skill	private_cooldown_bonus
private_crit_bonus	skill	private_crit_bonus
private_damage_bonus	skill	private_damage_bonus
private_damage_shield	skill	private_damage_shield
private_defense_bonus	skill	private_defense_bonus
private_defense_penalty	skill	private_defense_penalty
private_melee_dmg_bonus	skill	private_melee_dmg_bonus
private_melee_dmg_shield	skill	private_melee_dmg_shield
private_posture_override	skill	private_posture_override
private_raw_damage_bonus	skill	private_raw_damage_bonus
private_relative_level_mod	skill	private_relative_level_mod
private_state_resist_debuff	skill	private_state_resist_debuff
private_taunt_bonus	skill	private_taunt_bonus
proc_buff	procBuff	N_A
proc_resist_cold	procResist	cold
prop_bonus	scriptVar	prop_bonus
protect_master	bodyguardDefender	protect_master
pvp_adrenaline_ability	pvpAdrenalineAbility	pvp_adrenaline_ability
pvp_adrenaline_rebel_ability	pvpAdrenalineRebelAbility	pvp_adrenaline_rebel_ability
pvp_aura_buff_rebel_self	pvpAuraBuffSelf	pvp_aura_buff_self
pvp_aura_buff_self	pvpAuraBuffSelf	pvp_aura_buff_self
pvp_last_man_ability	pvpLastManAbility	pvp_last_man_ability
pvp_last_man_rebel_ability	pvpLastManAbility	pvp_last_man_rebel_ability
pvp_retaliation_ability	pvpRetaliationAbility	pvp_retaliation_ability
pvp_retaliation_rebel_ability	pvpRetaliationRebelAbility	pvp_retaliation_rebel_ability
pvp_unstoppable_ability	pvpUnstoppableAbility	pvp_unstoppable_ability
pvp_unstoppable_rebel_ability	pvpUnstoppableRebelAbility	pvp_unstoppable_rebel_ability
radar_invis	radarInvis	radar_invis
ranged_accuracy	skill	ranged_accuracy
ranged_defense	skill	ranged_defense
ranged_deflection	skill	saber_block
ranged_speed	skill	ranged_speed
razor_burst_handler	razorBurstHandler	razor_burst_handler
reac_buff	reactiveBuff	N_A
reduce_damage_dealt_to_kun_chaos	skill	reduce_damage_dealt_to_kun_chaos
reduce_damage_dealt_to_kun_order	skill	reduce_damage_dealt_to_kun_order
reduce_damage_taken_from_kun_chaos	skill	reduce_damage_taken_from_kun_chaos
reduce_damage_taken_from_kun_order	skill	reduce_damage_taken_from_kun_order
remove_incap_weakened	removeIncapWeaken	remove_incap_weakened
resist_mind_trick	skill	resistance_mind_trick
resistance_bleeding	skill	resistance_bleeding
resistance_disease	skill	resistance_disease
resistance_fire	skill	resistance_fire
resistance_poison	skill	resistance_poison
resistance_states	skill	resistance_states
rifle_accuracy	skill	rifle_accuracy	
rifle_speed	skill	rifle_speed	
saber_block	skill	saber_block	
script_var	scriptVar	N_A	
set_bonus_bh_utility_a_1	skill	set_bonus_bh_utility_a_1	
set_bonus_bh_utility_a_2	skill	set_bonus_bh_utility_a_2	"IF THE NAME of your added effect doesn't start with X, Y or Z then this is the wrong place to put it."
set_bonus_bh_utility_a_3	skill	set_bonus_bh_utility_a_3	
setSpecialType_kun_chaos	setSpecialType	setSpecialType_kun_chaos	
setSpecialType_kun_order	setSpecialType	setSpecialType_kun_order	
shield_master_pet	bodyguardDefender	shield_master_pet	
shield_master_player	bodyguardMaster	shield_master_player	
shields_assembly	skill	shields_assembly	
shields_experimentation	skill	shields_experimentation	
slope_move	skill	slope_move	
sm_how_are_you	commandGrant	sm_how_are_you	
sm_impossible_odds	hitByLuck	combat_all_attack_hit_by_luck	
sm_pistol_whip	pistolWhip	sm_pistol_whip
sm_skullduggery	missByLuck	combat_all_attack_miss_by_luck
sp_perfect_opportunity	skill	sp_perfect_opportunity
space_station	scriptVar	space_station
stamina	attrib	stamina
stamina_modified	skill	stamina_modified
stamina_percent	skillPercent	stamina_modified
staminaPercent	attribPercent	stamina
stance_defensive	stance	defense
stance_offensive	stance	offense
state_immunity	immunity	state_immunity
strength_modified	skill	strength_modified
strength_percent	skillPercent	strength_modified
strikethrough_vulnerable	skill	strikethrough_vulnerable
structure_assembly	skill	structure_assembly
structure_experimentation	skill	structure_experimentation
structure_station	scriptVar	structure_station
suppression	suppression	N_A
supress_movement	movementSupressingEffect	supress_movement
supression_handler	supression_handler	supressingFire
surveying	skill	surveying
tame_bonus	skill	tame_bonus
tame_non_aggro	skill	tame_non_aggro
thrown_accuracy	skill	thrown_accuracy
thrown_speed	skill	thrown_speed
trandoshan_ability_1	commandGrant	trandoshan_ability_1
trapping	skill	trapping
treasure_forage_mod	skill	treasure_forage_mod
twohandmelee_accuracy	skill	twohandmelee_accuracy
twohandmelee_speed	skill	twohandmelee_speed
unarmed_accuracy	skill	unarmed_accuracy
unarmed_damage	skill	unarmed_damage
unarmed_speed	skill	unarmed_speed
weapon_assembly	skill	weapon_assembly
weapon_experimentation	skill	weapon_experimentation
weapon_speed_mod	weaponSpeedMod	weapon_speed_mod
weapon_station	scriptVar	weapon_station
weapon_systems	skill	weapon_systems
weapon_systems_experimentation	skill	weapon_systems_experimentation
willpower	attrib	willpower
willpowerPercent	attribPercent	willpower
xp_bonus_architect	xpBonus	architect
xp_bonus_armorsmith	xpBonus	armorsmith
xp_bonus_artisan	xpBonus	artisan
xp_bonus_bioengineer	xpBonus	bio_engineer
xp_bonus_chef	xpBonus	chef
xp_bonus_dancer	xpBonus	dancer
xp_bonus_droidengineer	xpBonus	droidengineer
xp_bonus_entertainer	xpBonus	entertainer	
xp_bonus_general	xpBonusGeneral	xp_bonus_general	
xp_bonus_imagedesigner	xpBonus	imagedesigner	
xp_bonus_merchant	xpBonus	merchant	
xp_bonus_musician	xpBonus	musician	
xp_bonus_ranger	xpBonus	ranger	
xp_bonus_scout	xpBonus	scout	
xp_bonus_shipwright	xpBonus	shipwright	
xp_bonus_tailor	xpBonus	tailor	
xp_bonus_weaponsmith	xpBonus	weaponsmith	"IF THE NAME of your added effect doesn't start with X, Y or Z then this is the wrong place to put it."
damage_immune	damageImmune	damage_immune	
fs_choke_handler	fs_choke_handler	fs_choke_handler	
jedi_statue_light_debuff_handler	jediStatueLightDebuff	jedi_statue_light_debuff_handler	
jedi_statue_dark_debuff_handler	jediStatueDarkDebuff	jedi_statue_dark_debuff_handler	
fs_flurry_proc	fs_flurry_proc	fs_flurry_proc	
forceThrow	forceThrow	forceThrow	
attack_override_by_buff	skill	attack_override_by_buff
on_attack_remove	onAttackRemove	on_attack_remove
flawless_bead	skill	flawless_bead
supression_handler	supression_handler	supressingFire
supress_movement	movementSupressingEffect	supress_movement
expertise_co_killing_spree_target	skill	expertise_co_killing_spree_target
dot_reduction_acid	dotReduction	dot_reduction_acid
dot_reduction_heat	dotReduction	dot_reduction_heat
dot_reduction_cold	dotReduction	dot_reduction_cold
dot_reduction_electrical	dotReduction	dot_reduction_electrical
dot_reduction_kinetic	dotReduction	dot_reduction_kinetic
dot_reduction_energy	dotReduction	dot_reduction_energy
dot_reduction_poison	dotReduction	dot_reduction_poison
dot_reduction_disease	dotReduction	dot_reduction_disease
dot_reduction_bleeding	dotReduction	dot_reduction_bleeding
dot_reduction_all	dotReduction	dot_reduction_all
dot_reduction_elemental	dotReduction	dot_reduction_elemental
dot_reduction_natural	dotReduction	dot_reduction_natural
dot_divisor_acid	dotDivisor	dot_divisor_acid
dot_divisor_heat	dotDivisor	dot_divisor_heat
dot_divisor_cold	dotDivisor	dot_divisor_cold
dot_divisor_electrical	dotDivisor	dot_divisor_electrical
dot_divisor_kinetic	dotDivisor	dot_divisor_kinetic
dot_divisor_energy	dotDivisor	dot_divisor_energy
dot_divisor_poison	dotDivisor	dot_divisor_poison
dot_divisor_disease	dotDivisor	dot_divisor_disease
dot_divisor_bleeding	dotDivisor	dot_divisor_bleeding
dot_divisor_all	dotDivisor	dot_divisor_all
dot_divisor_elemental	dotDivisor	dot_divisor_elemental
dot_divisor_natural	dotDivisor	dot_divisor_natural
dot_resist_acid	skill	dot_resist_acid
dot_resist_heat	skill	dot_resist_heat
dot_resist_cold	skill	dot_resist_cold
dot_resist_electrical	skill	dot_resist_electrical
dot_resist_kinetic	skill	dot_resist_kinetic
dot_resist_energy	skill	dot_resist_energy
dot_resist_poison	skill	dot_resist_poison
dot_resist_disease	skill	dot_resist_disease
dot_resist_bleeding	skill	dot_resist_bleeding
dot_resist_all	skill	dot_resist_all
dot_resist_elemental	skill	dot_resist_elemental
dot_resist_natural	skill	dot_resist_natural
expertise_parry	skill	expertise_parry
expertise_block_chance	skill	expertise_block_chance
expertise_evasion_chance	skill	expertise_evasion_chance
expertise_strikethrough_chance	skill	expertise_strikethrough_chance
set_bonus_bh_utility_a_1	skill	set_bonus_bh_utility_a_1
set_bonus_bh_utility_a_2	skill	set_bonus_bh_utility_a_2
set_bonus_bh_utility_a_3	skill	set_bonus_bh_utility_a_3
mtp_meatlump_angry	mtpMeatlumpAngry	mtp_meatlump_angry
mtp_meatlump_happy	mtpMeatlumpHappy	mtp_meatlump_happy
event_halloween_bat_swarm	eventParticle	event_halloween_bat_swarm
food_station	scriptVar	food_station
armor_station	scriptVar	armor_station
structure_station	scriptVar	structure_station
weapon_station	scriptVar	weapon_station
space_station	scriptVar	space_station
event_halloween_costume	costume	event_halloween_costume
event_halloween_trick_cooldown	halloweenCooldown	event_halloween_trick_cooldown
bm_xp_mod_boost	skill	bm_xp_mod_boost
xp_granted_general	xpGrantedGeneral	xp_granted_general
tcg_xp_bonus	xpBonusGeneral	tcg_xp_buff
tcg_xp_granted	xpGrantedGeneral	tcg_xp_buff
event_halloween_spider_swarm	eventParticle	event_halloween_spider_swarm
event_halloween_coin_limit	halloweenCoinLimit	event_halloween_coin_limit		
iceblock_effect	iceblockEffect	iceblock_effect		
dot	n_a	n_a		used in buff tab to differentiate that this is a dot buff.
barricade_defender	barricadeDefender	barricade_defender		
snowspeeder_instructions	snowspeederInstructions	snowspeeder_instructions		
radar_hue	radarHue	radar_hue		
bh_shields_charged_handler	bhShieldsCharged	bh_shields_charged_handler		
bh_shields_handler	bhShields	bh_shields_handler		
wampa_boss_ice_throw_prep	wampaBossIceThrowPrep	wampa_boss_ice_throw_prep		
wampa_boss_tauntaun_throw_prep	wampaBossTauntaunThrowPrep	wampa_boss_tauntaun_throw_prep		
event_lifeday_imperial_competitive	lifedayCompetitiveBuff	event_lifeday_imperial_competitive		
event_lifeday_rebel_competitive	lifedayCompetitiveBuff	event_lifeday_rebel_competitive		
station_buff	craftingStation	station_buff		This handler does nothing other than prevent the station_buff from throwing a warning.
event_lifeday_imperial_competitive	lifedayCompetitiveBuff	event_lifeday_imperial_competitive		
event_lifeday_rebel_competitive	lifedayCompetitiveBuff	event_lifeday_rebel_competitive		
expertise_armor_neglect	skill	expertise_armor_neglect		
expertise_critical_damage_increase	skill	expertise_critical_damage_increase
stifle	skill	stifle
storyteller_costume	costume	storyteller_costume
costume_burning_effect	costumeBurningEffect	costume_burning_effect
loveday_hearts_effect	lovedayHeartsEffect	loveday_hearts_effect
random_collection_item	randomCollectionItem	random_collection_item
tcg_gcw_bonus	gcwBonusGeneral	tcg_gcw_bonus
looping_hands_particle	eventParticle	looping_hands_particle
milk_quantity_modified	skill	milk_quantity_modified
milk_exceptional_modified	skill	milk_exceptional_modified
milk_stun_modified	skill	milk_stun_modified
resistance_spice_downer	skill	resistance_spice_downer
resistance_incapacitation	skill	resistance_incapacitation
battlefield_communcations_glow	battlefieldCommuncationsGlow	battlefield_communcations_glow
empire_day_imperial_recruitment	empireDayImperialRecruitment	empire_day_imperial_recruitment
empire_day_rebel_resistance	empireDayRebelResistance	empire_day_rebel_resistance
empire_day_imperial_antipropaganda	empireDayImperialPropaganda	empire_day_imperial_antipropaganda
empire_day_rebel_vandal	empireDayRebelVandal	empire_day_rebel_vandal
death_troopers_afflicted_toss	deathTroopersAfflictedToss	death_troopers_afflicted_toss
kill_player	killPlayer	kill_player
outbreak_stacking_infection	outbreakStackingInfection	outbreak_stacking_infection
beast_scale_up	beastScaleChange	beast_scale_up
beast_scale_down	beastScaleChange	beast_scale_down
beast_auto_feeder	beastAutoFeeder	beast_auto_feeder
gcw_spy_destroy_patrol_explosive_stack	gcwSpyDestroyPatrolExplosives	gcw_spy_destroy_patrol_explosive_stack
gcw_general_resistance_stack_rebel	gcwGeneralResistanceStack	gcw_general_resistance_stack_rebel
gcw_general_resistance_stack_imperial	gcwGeneralResistanceStack	gcw_general_resistance_stack_imperial
expertise_damage_npc	skill	expertise_damage_npc
hit_always	skill	hit_always
saber_intercept	saberIntercept	saber_intercept
gcw_mini_turret	gcwMiniTurret	gcw_mini_turret
crit_always	skill	crit_always
